,State,StateFIPS,CountyFIPS,AreaName,All_Poverty,M_Poverty,F_Poverty
12,AK,02,013,"Aleutians East Borough, Alaska",553,334,219
13,AK,02,016,"Aleutians West Census Area, Alaska",499,273,226
14,AK,02,020,"Anchorage Municipality, Alaska",23914,10698,13216
15,AK,02,050,"Bethel Census Area, Alaska",4364,2199,2165
16,AK,02,060,"Bristol Bay Borough, Alaska",69,33,36
17,AK,02,068,"Denali Borough, Alaska",254,139,115
18,AK,02,070,"Dillingham Census Area, Alaska",894,446,448
19,AK,02,090,"Fairbanks North Star Borough, Alaska",7752,3523,4229
20,AK,02,100,"Haines Borough, Alaska",135,74,61
21,AK,02,105,"Hoonah-Angoon Census Area, Alaska",252,102,150
22,AK,02,110,"Juneau City and Borough, Alaska",2110,1145,965
23,AK,02,122,"Kenai Peninsula Borough, Alaska",5558,2596,2962
24,AK,02,130,"Ketchikan Gateway Borough, Alaska",1640,792,848
25,AK,02,150,"Kodiak Island Borough, Alaska",1552,962,590
26,AK,02,158,"Kusilvak Census Area, Alaska",2622,1290,1332
27,AK,02,164,"Lake and Peninsula Borough, Alaska",247,119,128
28,AK,02,170,"Matanuska-Susitna Borough, Alaska",9454,4346,5108
29,AK,02,180,"Nome Census Area, Alaska",2592,1399,1193
30,AK,02,185,"North Slope Borough, Alaska",976,532,444
31,AK,02,188,"Northwest Arctic Borough, Alaska",1824,951,873
32,AK,02,195,"Petersburg Borough, Alaska",327,174,153
33,AK,02,198,"Prince of Wales-Hyder Census Area, Alaska",921,475,446
34,AK,02,220,"Sitka City and Borough, Alaska",798,424,374
35,AK,02,230,"Skagway Municipality, Alaska",44,16,28
36,AK,02,240,"Southeast Fairbanks Census Area, Alaska",1011,507,504
37,AK,02,261,"Valdez-Cordova Census Area, Alaska",1029,598,431
38,AK,02,275,"Wrangell City and Borough, Alaska",279,153,126
39,AK,02,282,"Yakutat City and Borough, Alaska",35,25,10
40,AK,02,290,"Yukon-Koyukuk Census Area, Alaska",1252,666,586
12,AL,01,001,"Autauga County, Alabama",7057,2983,4074
13,AL,01,003,"Baldwin County, Alabama",25798,12018,13780
14,AL,01,005,"Barbour County, Alabama",6421,2856,3565
15,AL,01,007,"Bibb County, Alabama",3488,1495,1993
16,AL,01,009,"Blount County, Alabama",9552,4593,4959
17,AL,01,011,"Bullock County, Alabama",2486,981,1505
18,AL,01,013,"Butler County, Alabama",5094,2073,3021
19,AL,01,015,"Calhoun County, Alabama",23325,9500,13825
20,AL,01,017,"Chambers County, Alabama",7273,3091,4182
21,AL,01,019,"Cherokee County, Alabama",4918,2421,2497
22,AL,01,021,"Chilton County, Alabama",8288,3871,4417
23,AL,01,023,"Choctaw County, Alabama",3093,1206,1887
24,AL,01,025,"Clarke County, Alabama",6107,2495,3612
25,AL,01,027,"Clay County, Alabama",2201,902,1299
26,AL,01,029,"Cleburne County, Alabama",2508,1069,1439
27,AL,01,031,"Coffee County, Alabama",8581,3867,4714
28,AL,01,033,"Colbert County, Alabama",9406,4124,5282
29,AL,01,035,"Conecuh County, Alabama",4320,2011,2309
30,AL,01,037,"Coosa County, Alabama",2073,961,1112
31,AL,01,039,"Covington County, Alabama",7515,3263,4252
32,AL,01,041,"Crenshaw County, Alabama",2288,1068,1220
33,AL,01,043,"Cullman County, Alabama",14814,6760,8054
34,AL,01,045,"Dale County, Alabama",9306,4092,5214
35,AL,01,047,"Dallas County, Alabama",14580,5889,8691
36,AL,01,049,"DeKalb County, Alabama",13133,5783,7350
37,AL,01,051,"Elmore County, Alabama",10334,4413,5921
38,AL,01,053,"Escambia County, Alabama",8609,3695,4914
39,AL,01,055,"Etowah County, Alabama",20078,8854,11224
40,AL,01,057,"Fayette County, Alabama",3055,1449,1606
41,AL,01,059,"Franklin County, Alabama",7020,2598,4422
42,AL,01,061,"Geneva County, Alabama",6149,2689,3460
43,AL,01,063,"Greene County, Alabama",3479,1562,1917
44,AL,01,065,"Hale County, Alabama",4011,1638,2373
45,AL,01,067,"Henry County, Alabama",2657,1085,1572
46,AL,01,069,"Houston County, Alabama",18746,7893,10853
47,AL,01,071,"Jackson County, Alabama",9415,4398,5017
48,AL,01,073,"Jefferson County, Alabama",121029,52750,68279
49,AL,01,075,"Lamar County, Alabama",3382,1302,2080
50,AL,01,077,"Lauderdale County, Alabama",16232,6772,9460
51,AL,01,079,"Lawrence County, Alabama",6225,2780,3445
52,AL,01,081,"Lee County, Alabama",34561,15869,18692
53,AL,01,083,"Limestone County, Alabama",12075,5206,6869
54,AL,01,085,"Lowndes County, Alabama",3035,1353,1682
55,AL,01,087,"Macon County, Alabama",4636,2060,2576
56,AL,01,089,"Madison County, Alabama",46436,21195,25241
57,AL,01,091,"Marengo County, Alabama",5244,2056,3188
58,AL,01,093,"Marion County, Alabama",5960,2805,3155
59,AL,01,095,"Marshall County, Alabama",18794,8426,10368
60,AL,01,097,"Mobile County, Alabama",77917,31927,45990
61,AL,01,099,"Monroe County, Alabama",6901,2912,3989
62,AL,01,101,"Montgomery County, Alabama",49918,21699,28219
63,AL,01,103,"Morgan County, Alabama",18936,7640,11296
64,AL,01,105,"Perry County, Alabama",3373,1510,1863
65,AL,01,107,"Pickens County, Alabama",4801,2116,2685
66,AL,01,109,"Pike County, Alabama",8158,3810,4348
67,AL,01,111,"Randolph County, Alabama",4511,2048,2463
68,AL,01,113,"Russell County, Alabama",12054,4782,7272
69,AL,01,115,"St. Clair County, Alabama",13417,6115,7302
70,AL,01,117,"Shelby County, Alabama",16693,7492,9201
71,AL,01,119,"Sumter County, Alabama",5372,2187,3185
72,AL,01,121,"Talladega County, Alabama",17950,7613,10337
73,AL,01,123,"Tallapoosa County, Alabama",9117,3646,5471
74,AL,01,125,"Tuscaloosa County, Alabama",36274,15124,21150
75,AL,01,127,"Walker County, Alabama",14598,6480,8118
76,AL,01,129,"Washington County, Alabama",3200,1367,1833
77,AL,01,131,"Wilcox County, Alabama",4126,1910,2216
78,AL,01,133,"Winston County, Alabama",5157,2035,3122
12,AR,05,001,"Arkansas County, Arkansas",3705,1514,2191
13,AR,05,003,"Ashley County, Arkansas",4352,1961,2391
14,AR,05,005,"Baxter County, Arkansas",6452,3062,3390
15,AR,05,007,"Benton County, Arkansas",28804,13213,15591
16,AR,05,009,"Boone County, Arkansas",6465,2751,3714
17,AR,05,011,"Bradley County, Arkansas",3218,1350,1868
18,AR,05,013,"Calhoun County, Arkansas",907,409,498
19,AR,05,015,"Carroll County, Arkansas",5001,2173,2828
20,AR,05,017,"Chicot County, Arkansas",3385,1350,2035
21,AR,05,019,"Clark County, Arkansas",4716,1872,2844
22,AR,05,021,"Clay County, Arkansas",3324,1472,1852
23,AR,05,023,"Cleburne County, Arkansas",3676,1696,1980
24,AR,05,025,"Cleveland County, Arkansas",1751,785,966
25,AR,05,027,"Columbia County, Arkansas",5823,2540,3283
26,AR,05,029,"Conway County, Arkansas",4709,2344,2365
27,AR,05,031,"Craighead County, Arkansas",19715,8920,10795
28,AR,05,033,"Crawford County, Arkansas",11304,5456,5848
29,AR,05,035,"Crittenden County, Arkansas",11802,4745,7057
30,AR,05,037,"Cross County, Arkansas",3461,1459,2002
31,AR,05,039,"Dallas County, Arkansas",1141,521,620
32,AR,05,041,"Desha County, Arkansas",4029,1628,2401
33,AR,05,043,"Drew County, Arkansas",5023,2381,2642
34,AR,05,045,"Faulkner County, Arkansas",17768,7625,10143
35,AR,05,047,"Franklin County, Arkansas",3854,1651,2203
36,AR,05,049,"Fulton County, Arkansas",2383,1094,1289
37,AR,05,051,"Garland County, Arkansas",19802,9205,10597
38,AR,05,053,"Grant County, Arkansas",2134,943,1191
39,AR,05,055,"Greene County, Arkansas",7572,3161,4411
40,AR,05,057,"Hempstead County, Arkansas",5940,2685,3255
41,AR,05,059,"Hot Spring County, Arkansas",5975,2520,3455
42,AR,05,061,"Howard County, Arkansas",2910,1276,1634
43,AR,05,063,"Independence County, Arkansas",7783,3287,4496
44,AR,05,065,"Izard County, Arkansas",2663,1346,1317
45,AR,05,067,"Jackson County, Arkansas",3819,1759,2060
46,AR,05,069,"Jefferson County, Arkansas",17205,7764,9441
47,AR,05,071,"Johnson County, Arkansas",5574,2492,3082
48,AR,05,073,"Lafayette County, Arkansas",1731,692,1039
49,AR,05,075,"Lawrence County, Arkansas",3899,1796,2103
50,AR,05,077,"Lee County, Arkansas",2304,969,1335
51,AR,05,079,"Lincoln County, Arkansas",2257,1003,1254
52,AR,05,081,"Little River County, Arkansas",2402,1074,1328
53,AR,05,083,"Logan County, Arkansas",4158,1995,2163
54,AR,05,085,"Lonoke County, Arkansas",8697,3814,4883
55,AR,05,087,"Madison County, Arkansas",3183,1329,1854
56,AR,05,089,"Marion County, Arkansas",3064,1345,1719
57,AR,05,091,"Miller County, Arkansas",8594,3519,5075
58,AR,05,093,"Mississippi County, Arkansas",11781,4964,6817
59,AR,05,095,"Monroe County, Arkansas",2501,1078,1423
60,AR,05,097,"Montgomery County, Arkansas",1620,728,892
61,AR,05,099,"Nevada County, Arkansas",2424,1176,1248
62,AR,05,101,"Newton County, Arkansas",1637,648,989
63,AR,05,103,"Ouachita County, Arkansas",5948,2211,3737
64,AR,05,105,"Perry County, Arkansas",1624,509,1115
65,AR,05,107,"Phillips County, Arkansas",6882,2991,3891
66,AR,05,109,"Pike County, Arkansas",2199,999,1200
67,AR,05,111,"Poinsett County, Arkansas",5416,2410,3006
68,AR,05,113,"Polk County, Arkansas",4878,2389,2489
69,AR,05,115,"Pope County, Arkansas",11818,5525,6293
70,AR,05,117,"Prairie County, Arkansas",1766,775,991
71,AR,05,119,"Pulaski County, Arkansas",67908,30871,37037
72,AR,05,121,"Randolph County, Arkansas",3651,1897,1754
73,AR,05,123,"St. Francis County, Arkansas",5857,2661,3196
74,AR,05,125,"Saline County, Arkansas",10176,4896,5280
75,AR,05,127,"Scott County, Arkansas",2165,1061,1104
76,AR,05,129,"Searcy County, Arkansas",1855,986,869
77,AR,05,131,"Sebastian County, Arkansas",28975,12570,16405
78,AR,05,133,"Sevier County, Arkansas",3755,1807,1948
79,AR,05,135,"Sharp County, Arkansas",3944,1700,2244
80,AR,05,137,"Stone County, Arkansas",3042,1414,1628
81,AR,05,139,"Union County, Arkansas",8172,3577,4595
82,AR,05,141,"Van Buren County, Arkansas",3574,1438,2136
83,AR,05,143,"Washington County, Arkansas",41846,19505,22341
84,AR,05,145,"White County, Arkansas",14175,6412,7763
85,AR,05,147,"Woodruff County, Arkansas",1612,740,872
86,AR,05,149,"Yell County, Arkansas",4009,1862,2147
12,AZ,04,001,"Apache County, Arizona",25852,12854,12998
13,AZ,04,003,"Cochise County, Arizona",21102,8595,12507
14,AZ,04,005,"Coconino County, Arizona",28824,13662,15162
15,AZ,04,007,"Gila County, Arizona",11839,5365,6474
16,AZ,04,009,"Graham County, Arizona",7446,3377,4069
17,AZ,04,011,"Greenlee County, Arizona",1215,538,677
18,AZ,04,012,"La Paz County, Arizona",3824,1851,1973
19,AZ,04,013,"Maricopa County, Arizona",673527,313707,359820
20,AZ,04,015,"Mohave County, Arizona",38874,18410,20464
21,AZ,04,017,"Navajo County, Arizona",32141,15025,17116
22,AZ,04,019,"Pima County, Arizona",187250,86251,100999
23,AZ,04,021,"Pinal County, Arizona",63201,28120,35081
24,AZ,04,023,"Santa Cruz County, Arizona",10970,5162,5808
25,AZ,04,025,"Yavapai County, Arizona",34117,16249,17868
26,AZ,04,027,"Yuma County, Arizona",40508,18351,22157
12,CA,06,001,"Alameda County, California",194639,87343,107296
13,CA,06,003,"Alpine County, California",195,106,89
14,CA,06,005,"Amador County, California",4191,1886,2305
15,CA,06,007,"Butte County, California",47532,23533,23999
16,CA,06,009,"Calaveras County, California",5590,2433,3157
17,CA,06,011,"Colusa County, California",3171,1590,1581
18,CA,06,013,"Contra Costa County, California",117915,52269,65646
19,CA,06,015,"Del Norte County, California",5207,2385,2822
20,CA,06,017,"El Dorado County, California",18831,9082,9749
21,CA,06,019,"Fresno County, California",252187,117772,134415
22,CA,06,021,"Glenn County, California",5721,2544,3177
23,CA,06,023,"Humboldt County, California",28158,13202,14956
24,CA,06,025,"Imperial County, California",40114,18036,22078
25,CA,06,027,"Inyo County, California",2019,907,1112
26,CA,06,029,"Kern County, California",195744,87585,108159
27,CA,06,031,"Kings County, California",29900,13392,16508
28,CA,06,033,"Lake County, California",15597,7932,7665
29,CA,06,035,"Lassen County, California",3563,1814,1749
30,CA,06,037,"Los Angeles County, California",1800265,823612,976653
31,CA,06,039,"Madera County, California",33968,15721,18247
32,CA,06,041,"Marin County, California",20964,9707,11257
33,CA,06,043,"Mariposa County, California",2651,1264,1387
34,CA,06,045,"Mendocino County, California",17527,8215,9312
35,CA,06,047,"Merced County, California",67417,32269,35148
36,CA,06,049,"Modoc County, California",1673,833,840
37,CA,06,051,"Mono County, California",684,344,340
38,CA,06,053,"Monterey County, California",69475,31992,37483
39,CA,06,055,"Napa County, California",14020,6923,7097
40,CA,06,057,"Nevada County, California",12367,5582,6785
41,CA,06,059,"Orange County, California",395483,182267,213216
42,CA,06,061,"Placer County, California",32427,15480,16947
43,CA,06,063,"Plumas County, California",2687,1168,1519
44,CA,06,065,"Riverside County, California",379985,175705,204280
45,CA,06,067,"Sacramento County, California",262251,122854,139397
46,CA,06,069,"San Benito County, California",6202,2722,3480
47,CA,06,071,"San Bernardino County, California",397766,178898,218868
48,CA,06,073,"San Diego County, California",454876,210952,243924
49,CA,06,075,"San Francisco County, California",109524,52571,56953
50,CA,06,077,"San Joaquin County, California",129390,59724,69666
51,CA,06,079,"San Luis Obispo County, California",38630,18816,19814
52,CA,06,081,"San Mateo County, California",59232,26750,32482
53,CA,06,083,"Santa Barbara County, California",68017,32772,35245
54,CA,06,085,"Santa Clara County, California",175690,81461,94229
55,CA,06,087,"Santa Cruz County, California",39053,17482,21571
56,CA,06,089,"Shasta County, California",31707,14584,17123
57,CA,06,091,"Sierra County, California",438,180,258
58,CA,06,093,"Siskiyou County, California",10026,4814,5212
59,CA,06,095,"Solano County, California",55534,24891,30643
60,CA,06,097,"Sonoma County, California",57179,26643,30536
61,CA,06,099,"Stanislaus County, California",105927,48153,57774
62,CA,06,101,"Sutter County, California",16743,7675,9068
63,CA,06,103,"Tehama County, California",12313,5604,6709
64,CA,06,105,"Trinity County, California",2562,1226,1336
65,CA,06,107,"Tulare County, California",125775,60834,64941
66,CA,06,109,"Tuolumne County, California",7010,3092,3918
67,CA,06,111,"Ventura County, California",91880,42180,49700
68,CA,06,113,"Yolo County, California",39688,18185,21503
69,CA,06,115,"Yuba County, California",15862,7384,8478
12,CO,08,001,"Adams County, Colorado",64241,29134,35107
13,CO,08,003,"Alamosa County, Colorado",4396,1771,2625
14,CO,08,005,"Arapahoe County, Colorado",67679,31140,36539
15,CO,08,007,"Archuleta County, Colorado",1405,661,744
16,CO,08,009,"Baca County, Colorado",736,308,428
17,CO,08,011,"Bent County, Colorado",923,473,450
18,CO,08,013,"Boulder County, Colorado",42167,20822,21345
19,CO,08,014,"Broomfield County, Colorado",3930,1582,2348
20,CO,08,015,"Chaffee County, Colorado",1502,647,855
21,CO,08,017,"Cheyenne County, Colorado",168,78,90
22,CO,08,019,"Clear Creek County, Colorado",748,352,396
23,CO,08,021,"Conejos County, Colorado",1491,735,756
24,CO,08,023,"Costilla County, Colorado",850,354,496
25,CO,08,025,"Crowley County, Colorado",1449,587,862
26,CO,08,027,"Custer County, Colorado",736,385,351
27,CO,08,029,"Delta County, Colorado",4716,2086,2630
28,CO,08,031,"Denver County, Colorado",110299,52215,58084
29,CO,08,033,"Dolores County, Colorado",398,218,180
30,CO,08,035,"Douglas County, Colorado",12110,5653,6457
31,CO,08,037,"Eagle County, Colorado",4780,2769,2011
32,CO,08,039,"Elbert County, Colorado",1649,819,830
33,CO,08,041,"El Paso County, Colorado",75033,33973,41060
34,CO,08,043,"Fremont County, Colorado",6272,2828,3444
35,CO,08,045,"Garfield County, Colorado",6786,3452,3334
36,CO,08,047,"Gilpin County, Colorado",413,188,225
37,CO,08,049,"Grand County, Colorado",1543,733,810
38,CO,08,051,"Gunnison County, Colorado",2509,1163,1346
39,CO,08,053,"Hinsdale County, Colorado",70,34,36
40,CO,08,055,"Huerfano County, Colorado",1171,646,525
41,CO,08,057,"Jackson County, Colorado",155,71,84
42,CO,08,059,"Jefferson County, Colorado",46423,20756,25667
43,CO,08,061,"Kiowa County, Colorado",189,68,121
44,CO,08,063,"Kit Carson County, Colorado",1157,444,713
45,CO,08,065,"Lake County, Colorado",833,373,460
46,CO,08,067,"La Plata County, Colorado",5432,2273,3159
47,CO,08,069,"Larimer County, Colorado",42338,19766,22572
48,CO,08,071,"Las Animas County, Colorado",2055,1039,1016
49,CO,08,073,"Lincoln County, Colorado",624,223,401
50,CO,08,075,"Logan County, Colorado",3529,1745,1784
51,CO,08,077,"Mesa County, Colorado",22545,10438,12107
52,CO,08,079,"Mineral County, Colorado",56,18,38
53,CO,08,081,"Moffat County, Colorado",1462,703,759
54,CO,08,083,"Montezuma County, Colorado",4550,2193,2357
55,CO,08,085,"Montrose County, Colorado",7644,3476,4168
56,CO,08,087,"Morgan County, Colorado",3218,1172,2046
57,CO,08,089,"Otero County, Colorado",4396,2097,2299
58,CO,08,091,"Ouray County, Colorado",355,174,181
59,CO,08,093,"Park County, Colorado",1170,563,607
60,CO,08,095,"Phillips County, Colorado",658,293,365
61,CO,08,097,"Pitkin County, Colorado",1709,663,1046
62,CO,08,099,"Prowers County, Colorado",2264,993,1271
63,CO,08,101,"Pueblo County, Colorado",31017,14201,16816
64,CO,08,103,"Rio Blanco County, Colorado",1113,521,592
65,CO,08,105,"Rio Grande County, Colorado",2198,1070,1128
66,CO,08,107,"Routt County, Colorado",2369,1338,1031
67,CO,08,109,"Saguache County, Colorado",1450,609,841
68,CO,08,111,"San Juan County, Colorado",100,48,52
69,CO,08,113,"San Miguel County, Colorado",854,398,456
70,CO,08,115,"Sedgwick County, Colorado",335,138,197
71,CO,08,117,"Summit County, Colorado",3949,1928,2021
72,CO,08,119,"Teller County, Colorado",1728,826,902
73,CO,08,121,"Washington County, Colorado",466,184,282
74,CO,08,123,"Weld County, Colorado",34007,15469,18538
75,CO,08,125,"Yuma County, Colorado",1451,599,852
11,CT,09,001,"Fairfield County, Connecticut",82743,36089,46654
12,CT,09,003,"Hartford County, Connecticut",104196,46770,57426
13,CT,09,005,"Litchfield County, Connecticut",12893,6253,6640
14,CT,09,007,"Middlesex County, Connecticut",10710,4712,5998
15,CT,09,009,"New Haven County, Connecticut",108533,46592,61941
16,CT,09,011,"New London County, Connecticut",25766,11243,14523
17,CT,09,013,"Tolland County, Connecticut",9511,4404,5107
18,CT,09,015,"Windham County, Connecticut",11999,4937,7062
5,DC,11,001,"District of Columbia, District of Columbia",110365,48069,62296
7,DE,10,001,"Kent County, Delaware",22074,9294,12780
8,DE,10,003,"New Castle County, Delaware",60487,25747,34740
9,DE,10,005,"Sussex County, Delaware",25754,11078,14676
12,FL,12,001,"Alachua County, Florida",58203,27526,30677
13,FL,12,003,"Baker County, Florida",4393,1849,2544
14,FL,12,005,"Bay County, Florida",26235,11556,14679
15,FL,12,007,"Bradford County, Florida",4896,2208,2688
16,FL,12,009,"Brevard County, Florida",76460,35131,41329
17,FL,12,011,"Broward County, Florida",265880,119303,146577
18,FL,12,013,"Calhoun County, Florida",2407,1034,1373
19,FL,12,015,"Charlotte County, Florida",19760,8772,10988
20,FL,12,017,"Citrus County, Florida",23903,10602,13301
21,FL,12,019,"Clay County, Florida",20580,9158,11422
22,FL,12,021,"Collier County, Florida",47436,22674,24762
23,FL,12,023,"Columbia County, Florida",12498,5458,7040
24,FL,12,027,"DeSoto County, Florida",10123,5668,4455
25,FL,12,029,"Dixie County, Florida",3061,1320,1741
26,FL,12,031,"Duval County, Florida",150792,66314,84478
27,FL,12,033,"Escambia County, Florida",45308,20987,24321
28,FL,12,035,"Flagler County, Florida",14814,6979,7835
29,FL,12,037,"Franklin County, Florida",1977,872,1105
30,FL,12,039,"Gadsden County, Florida",11907,5937,5970
31,FL,12,041,"Gilchrist County, Florida",3598,1705,1893
32,FL,12,043,"Glades County, Florida",2408,1150,1258
33,FL,12,045,"Gulf County, Florida",1924,830,1094
34,FL,12,047,"Hamilton County, Florida",3234,1467,1767
35,FL,12,049,"Hardee County, Florida",7029,3262,3767
36,FL,12,051,"Hendry County, Florida",9696,4898,4798
37,FL,12,053,"Hernando County, Florida",27375,12662,14713
38,FL,12,055,"Highlands County, Florida",18863,9056,9807
39,FL,12,057,"Hillsborough County, Florida",217684,98476,119208
40,FL,12,059,"Holmes County, Florida",4903,2374,2529
41,FL,12,061,"Indian River County, Florida",20272,8950,11322
42,FL,12,063,"Jackson County, Florida",9090,4056,5034
43,FL,12,065,"Jefferson County, Florida",1862,741,1121
44,FL,12,067,"Lafayette County, Florida",1425,563,862
45,FL,12,069,"Lake County, Florida",42497,19644,22853
46,FL,12,071,"Lee County, Florida",105166,48604,56562
47,FL,12,073,"Leon County, Florida",60286,28018,32268
48,FL,12,075,"Levy County, Florida",8601,4159,4442
49,FL,12,077,"Liberty County, Florida",1237,711,526
50,FL,12,079,"Madison County, Florida",4269,1989,2280
51,FL,12,081,"Manatee County, Florida",51595,23144,28451
52,FL,12,083,"Marion County, Florida",60207,26829,33378
53,FL,12,085,"Martin County, Florida",17965,8725,9240
54,FL,12,086,"Miami-Dade County, Florida",530006,234079,295927
55,FL,12,087,"Monroe County, Florida",9998,4952,5046
56,FL,12,089,"Nassau County, Florida",9652,4524,5128
57,FL,12,091,"Okaloosa County, Florida",24595,11057,13538
58,FL,12,093,"Okeechobee County, Florida",9965,4747,5218
59,FL,12,095,"Orange County, Florida",212489,96829,115660
60,FL,12,097,"Osceola County, Florida",58146,26746,31400
61,FL,12,099,"Palm Beach County, Florida",197340,88523,108817
62,FL,12,101,"Pasco County, Florida",66144,29154,36990
63,FL,12,103,"Pinellas County, Florida",131643,58929,72714
64,FL,12,105,"Polk County, Florida",111877,50847,61030
65,FL,12,107,"Putnam County, Florida",20397,9041,11356
66,FL,12,109,"St. Johns County, Florida",19706,8625,11081
67,FL,12,111,"St. Lucie County, Florida",52201,24225,27976
68,FL,12,113,"Santa Rosa County, Florida",19063,8482,10581
69,FL,12,115,"Sarasota County, Florida",42386,19475,22911
70,FL,12,117,"Seminole County, Florida",52637,24575,28062
71,FL,12,119,"Sumter County, Florida",10802,4602,6200
72,FL,12,121,"Suwannee County, Florida",10012,4500,5512
73,FL,12,123,"Taylor County, Florida",2720,1226,1494
74,FL,12,125,"Union County, Florida",2002,814,1188
75,FL,12,127,"Volusia County, Florida",85881,39086,46795
76,FL,12,129,"Wakulla County, Florida",4101,1658,2443
77,FL,12,131,"Walton County, Florida",9804,5087,4717
78,FL,12,133,"Washington County, Florida",4723,2407,2316
12,GA,13,001,"Appling County, Georgia",3745,1485,2260
13,GA,13,003,"Atkinson County, Georgia",2370,1068,1302
14,GA,13,005,"Bacon County, Georgia",1919,850,1069
15,GA,13,007,"Baker County, Georgia",752,287,465
16,GA,13,009,"Baldwin County, Georgia",13201,5601,7600
17,GA,13,011,"Banks County, Georgia",3026,1497,1529
18,GA,13,013,"Barrow County, Georgia",10902,5099,5803
19,GA,13,015,"Bartow County, Georgia",15819,6659,9160
20,GA,13,017,"Ben Hill County, Georgia",6024,2511,3513
21,GA,13,019,"Berrien County, Georgia",4923,2088,2835
22,GA,13,021,"Bibb County, Georgia",40611,16798,23813
23,GA,13,023,"Bleckley County, Georgia",2616,1270,1346
24,GA,13,025,"Brantley County, Georgia",3812,1561,2251
25,GA,13,027,"Brooks County, Georgia",4265,1864,2401
26,GA,13,029,"Bryan County, Georgia",4487,1939,2548
27,GA,13,031,"Bulloch County, Georgia",21794,10148,11646
28,GA,13,033,"Burke County, Georgia",7131,3099,4032
29,GA,13,035,"Butts County, Georgia",4329,2023,2306
30,GA,13,037,"Calhoun County, Georgia",1924,891,1033
31,GA,13,039,"Camden County, Georgia",6365,2795,3570
32,GA,13,043,"Candler County, Georgia",3398,1480,1918
33,GA,13,045,"Carroll County, Georgia",22441,9360,13081
34,GA,13,047,"Catoosa County, Georgia",8061,3588,4473
35,GA,13,049,"Charlton County, Georgia",2010,1140,870
36,GA,13,051,"Chatham County, Georgia",50980,21510,29470
37,GA,13,053,"Chattahoochee County, Georgia",960,569,391
38,GA,13,055,"Chattooga County, Georgia",5488,2243,3245
39,GA,13,057,"Cherokee County, Georgia",24273,11323,12950
40,GA,13,059,"Clarke County, Georgia",40559,18801,21758
41,GA,13,061,"Clay County, Georgia",1285,579,706
42,GA,13,063,"Clayton County, Georgia",65787,29093,36694
43,GA,13,065,"Clinch County, Georgia",2339,915,1424
44,GA,13,067,"Cobb County, Georgia",87880,40060,47820
45,GA,13,069,"Coffee County, Georgia",9975,4089,5886
46,GA,13,071,"Colquitt County, Georgia",12086,5622,6464
47,GA,13,073,"Columbia County, Georgia",12517,5247,7270
48,GA,13,075,"Cook County, Georgia",4244,1837,2407
49,GA,13,077,"Coweta County, Georgia",17489,7061,10428
50,GA,13,079,"Crawford County, Georgia",2122,984,1138
51,GA,13,081,"Crisp County, Georgia",7468,3161,4307
52,GA,13,083,"Dade County, Georgia",2300,986,1314
53,GA,13,085,"Dawson County, Georgia",3156,1372,1784
54,GA,13,087,"Decatur County, Georgia",7418,3071,4347
55,GA,13,089,"DeKalb County, Georgia",135469,61067,74402
56,GA,13,091,"Dodge County, Georgia",4279,2065,2214
57,GA,13,093,"Dooly County, Georgia",3673,1729,1944
58,GA,13,095,"Dougherty County, Georgia",27557,11753,15804
59,GA,13,097,"Douglas County, Georgia",22118,9856,12262
60,GA,13,099,"Early County, Georgia",2916,1293,1623
61,GA,13,101,"Echols County, Georgia",1170,436,734
62,GA,13,103,"Effingham County, Georgia",5749,2473,3276
63,GA,13,105,"Elbert County, Georgia",3664,1459,2205
64,GA,13,107,"Emanuel County, Georgia",6700,3151,3549
65,GA,13,109,"Evans County, Georgia",2857,1127,1730
66,GA,13,111,"Fannin County, Georgia",5404,2047,3357
67,GA,13,113,"Fayette County, Georgia",9129,3883,5246
68,GA,13,115,"Floyd County, Georgia",19605,9048,10557
69,GA,13,117,"Forsyth County, Georgia",13547,5932,7615
70,GA,13,119,"Franklin County, Georgia",5122,2253,2869
71,GA,13,121,"Fulton County, Georgia",167391,72577,94814
72,GA,13,123,"Gilmer County, Georgia",6664,3541,3123
73,GA,13,125,"Glascock County, Georgia",483,237,246
74,GA,13,127,"Glynn County, Georgia",14981,6339,8642
75,GA,13,129,"Gordon County, Georgia",11188,5321,5867
76,GA,13,131,"Grady County, Georgia",7648,3529,4119
77,GA,13,133,"Greene County, Georgia",4033,1870,2163
78,GA,13,135,"Gwinnett County, Georgia",117553,54558,62995
79,GA,13,137,"Habersham County, Georgia",7220,3357,3863
80,GA,13,139,"Hall County, Georgia",34120,16393,17727
81,GA,13,141,"Hancock County, Georgia",2113,835,1278
82,GA,13,143,"Haralson County, Georgia",5724,2583,3141
83,GA,13,145,"Harris County, Georgia",2991,1317,1674
84,GA,13,147,"Hart County, Georgia",5403,2421,2982
85,GA,13,149,"Heard County, Georgia",2349,1048,1301
86,GA,13,151,"Henry County, Georgia",27162,11870,15292
87,GA,13,153,"Houston County, Georgia",25111,10623,14488
88,GA,13,155,"Irwin County, Georgia",2300,1081,1219
89,GA,13,157,"Jackson County, Georgia",8314,3770,4544
90,GA,13,159,"Jasper County, Georgia",2785,1269,1516
91,GA,13,161,"Jeff Davis County, Georgia",3309,1383,1926
92,GA,13,163,"Jefferson County, Georgia",4889,2228,2661
93,GA,13,165,"Jenkins County, Georgia",2984,1335,1649
94,GA,13,167,"Johnson County, Georgia",2125,1064,1061
95,GA,13,169,"Jones County, Georgia",4770,2119,2651
96,GA,13,171,"Lamar County, Georgia",3713,1794,1919
97,GA,13,173,"Lanier County, Georgia",2675,1226,1449
98,GA,13,175,"Laurens County, Georgia",12823,5604,7219
99,GA,13,177,"Lee County, Georgia",3417,1356,2061
100,GA,13,179,"Liberty County, Georgia",11047,4963,6084
101,GA,13,181,"Lincoln County, Georgia",1912,799,1113
102,GA,13,183,"Long County, Georgia",2936,1244,1692
103,GA,13,185,"Lowndes County, Georgia",28907,13270,15637
104,GA,13,187,"Lumpkin County, Georgia",5559,2398,3161
105,GA,13,189,"McDuffie County, Georgia",5410,2397,3013
106,GA,13,191,"McIntosh County, Georgia",2956,1296,1660
107,GA,13,193,"Macon County, Georgia",3639,1541,2098
108,GA,13,195,"Madison County, Georgia",4798,2176,2622
109,GA,13,197,"Marion County, Georgia",1836,640,1196
110,GA,13,199,"Meriwether County, Georgia",4733,2135,2598
111,GA,13,201,"Miller County, Georgia",1608,648,960
112,GA,13,205,"Mitchell County, Georgia",5905,2385,3520
113,GA,13,207,"Monroe County, Georgia",3492,1480,2012
114,GA,13,209,"Montgomery County, Georgia",2076,979,1097
115,GA,13,211,"Morgan County, Georgia",2529,1047,1482
116,GA,13,213,"Murray County, Georgia",7765,3685,4080
117,GA,13,215,"Muscogee County, Georgia",38921,16697,22224
118,GA,13,217,"Newton County, Georgia",17281,7478,9803
119,GA,13,219,"Oconee County, Georgia",2487,1084,1403
120,GA,13,221,"Oglethorpe County, Georgia",2316,1054,1262
121,GA,13,223,"Paulding County, Georgia",18445,7439,11006
122,GA,13,225,"Peach County, Georgia",5471,2439,3032
123,GA,13,227,"Pickens County, Georgia",3418,1479,1939
124,GA,13,229,"Pierce County, Georgia",4455,2269,2186
125,GA,13,231,"Pike County, Georgia",2132,1008,1124
126,GA,13,233,"Polk County, Georgia",8767,3831,4936
127,GA,13,235,"Pulaski County, Georgia",1929,655,1274
128,GA,13,237,"Putnam County, Georgia",3446,1912,1534
129,GA,13,239,"Quitman County, Georgia",558,208,350
130,GA,13,241,"Rabun County, Georgia",3458,1544,1914
131,GA,13,243,"Randolph County, Georgia",2145,1079,1066
132,GA,13,245,"Richmond County, Georgia",48498,20943,27555
133,GA,13,247,"Rockdale County, Georgia",14155,6535,7620
134,GA,13,249,"Schley County, Georgia",1187,512,675
135,GA,13,251,"Screven County, Georgia",3482,1551,1931
136,GA,13,253,"Seminole County, Georgia",1595,594,1001
137,GA,13,255,"Spalding County, Georgia",14238,5975,8263
138,GA,13,257,"Stephens County, Georgia",4707,2468,2239
139,GA,13,259,"Stewart County, Georgia",1645,693,952
140,GA,13,261,"Sumter County, Georgia",9741,4124,5617
141,GA,13,263,"Talbot County, Georgia",1291,630,661
142,GA,13,265,"Taliaferro County, Georgia",511,195,316
143,GA,13,267,"Tattnall County, Georgia",5646,2173,3473
144,GA,13,269,"Taylor County, Georgia",2351,1041,1310
145,GA,13,271,"Telfair County, Georgia",3565,1401,2164
146,GA,13,273,"Terrell County, Georgia",3216,1329,1887
147,GA,13,275,"Thomas County, Georgia",10335,4943,5392
148,GA,13,277,"Tift County, Georgia",11372,4841,6531
149,GA,13,279,"Toombs County, Georgia",6674,2769,3905
150,GA,13,281,"Towns County, Georgia",1862,817,1045
151,GA,13,283,"Treutlen County, Georgia",1242,491,751
152,GA,13,285,"Troup County, Georgia",14388,5631,8757
153,GA,13,287,"Turner County, Georgia",2027,1067,960
154,GA,13,289,"Twiggs County, Georgia",2324,976,1348
155,GA,13,291,"Union County, Georgia",2860,1353,1507
156,GA,13,293,"Upson County, Georgia",6137,2988,3149
157,GA,13,295,"Walker County, Georgia",11818,5435,6383
158,GA,13,297,"Walton County, Georgia",11801,4642,7159
159,GA,13,299,"Ware County, Georgia",9686,3807,5879
160,GA,13,301,"Warren County, Georgia",1485,619,866
161,GA,13,303,"Washington County, Georgia",4961,2052,2909
162,GA,13,305,"Wayne County, Georgia",5633,2316,3317
163,GA,13,307,"Webster County, Georgia",608,222,386
164,GA,13,309,"Wheeler County, Georgia",1177,404,773
165,GA,13,311,"White County, Georgia",5195,2364,2831
166,GA,13,313,"Whitfield County, Georgia",19270,8532,10738
167,GA,13,315,"Wilcox County, Georgia",1599,675,924
168,GA,13,317,"Wilkes County, Georgia",2795,1122,1673
169,GA,13,319,"Wilkinson County, Georgia",1640,661,979
170,GA,13,321,"Worth County, Georgia",4445,1961,2484
11,HI,15,001,"Hawaii County, Hawaii",36756,17957,18799
12,HI,15,003,"Honolulu County, Hawaii",92404,41559,50845
13,HI,15,005,"Kalawao County, Hawaii",12,5,7
14,HI,15,007,"Kauai County, Hawaii",7384,3291,4093
15,HI,15,009,"Maui County, Hawaii",17388,7899,9489
12,IA,19,001,"Adair County, Iowa",764,274,490
13,IA,19,003,"Adams County, Iowa",388,177,211
14,IA,19,005,"Allamakee County, Iowa",1491,620,871
15,IA,19,007,"Appanoose County, Iowa",1719,749,970
16,IA,19,009,"Audubon County, Iowa",552,204,348
17,IA,19,011,"Benton County, Iowa",2440,1215,1225
18,IA,19,013,"Black Hawk County, Iowa",19887,8889,10998
19,IA,19,015,"Boone County, Iowa",2588,1093,1495
20,IA,19,017,"Bremer County, Iowa",1894,671,1223
21,IA,19,019,"Buchanan County, Iowa",1970,843,1127
22,IA,19,021,"Buena Vista County, Iowa",2452,1068,1384
23,IA,19,023,"Butler County, Iowa",1322,533,789
24,IA,19,025,"Calhoun County, Iowa",1384,658,726
25,IA,19,027,"Carroll County, Iowa",2047,675,1372
26,IA,19,029,"Cass County, Iowa",1855,888,967
27,IA,19,031,"Cedar County, Iowa",1393,615,778
28,IA,19,033,"Cerro Gordo County, Iowa",5665,2333,3332
29,IA,19,035,"Cherokee County, Iowa",1281,565,716
30,IA,19,037,"Chickasaw County, Iowa",1067,493,574
31,IA,19,039,"Clarke County, Iowa",1493,658,835
32,IA,19,041,"Clay County, Iowa",1848,727,1121
33,IA,19,043,"Clayton County, Iowa",1941,799,1142
34,IA,19,045,"Clinton County, Iowa",6608,2840,3768
35,IA,19,047,"Crawford County, Iowa",3367,1594,1773
36,IA,19,049,"Dallas County, Iowa",4796,2038,2758
37,IA,19,051,"Davis County, Iowa",1657,662,995
38,IA,19,053,"Decatur County, Iowa",1541,722,819
39,IA,19,055,"Delaware County, Iowa",1717,855,862
40,IA,19,057,"Des Moines County, Iowa",6010,2095,3915
41,IA,19,059,"Dickinson County, Iowa",1100,433,667
42,IA,19,061,"Dubuque County, Iowa",11189,4826,6363
43,IA,19,063,"Emmet County, Iowa",1250,524,726
44,IA,19,065,"Fayette County, Iowa",2550,1189,1361
45,IA,19,067,"Floyd County, Iowa",1957,836,1121
46,IA,19,069,"Franklin County, Iowa",1372,651,721
47,IA,19,071,"Fremont County, Iowa",757,372,385
48,IA,19,073,"Greene County, Iowa",1135,460,675
49,IA,19,075,"Grundy County, Iowa",757,288,469
50,IA,19,077,"Guthrie County, Iowa",1199,515,684
51,IA,19,079,"Hamilton County, Iowa",1712,700,1012
52,IA,19,081,"Hancock County, Iowa",924,413,511
53,IA,19,083,"Hardin County, Iowa",1454,584,870
54,IA,19,085,"Harrison County, Iowa",1398,633,765
55,IA,19,087,"Henry County, Iowa",2695,1303,1392
56,IA,19,089,"Howard County, Iowa",1081,472,609
57,IA,19,091,"Humboldt County, Iowa",1155,447,708
58,IA,19,093,"Ida County, Iowa",809,395,414
59,IA,19,095,"Iowa County, Iowa",1391,615,776
60,IA,19,097,"Jackson County, Iowa",2343,899,1444
61,IA,19,099,"Jasper County, Iowa",3342,1456,1886
62,IA,19,101,"Jefferson County, Iowa",2311,1294,1017
63,IA,19,103,"Johnson County, Iowa",23537,11609,11928
64,IA,19,105,"Jones County, Iowa",1950,828,1122
65,IA,19,107,"Keokuk County, Iowa",1374,613,761
66,IA,19,109,"Kossuth County, Iowa",1357,532,825
67,IA,19,111,"Lee County, Iowa",5791,2606,3185
68,IA,19,113,"Linn County, Iowa",20747,9853,10894
69,IA,19,115,"Louisa County, Iowa",1357,589,768
70,IA,19,117,"Lucas County, Iowa",1126,596,530
71,IA,19,119,"Lyon County, Iowa",843,404,439
72,IA,19,121,"Madison County, Iowa",1164,567,597
73,IA,19,123,"Mahaska County, Iowa",3206,1330,1876
74,IA,19,125,"Marion County, Iowa",3124,1459,1665
75,IA,19,127,"Marshall County, Iowa",4429,2268,2161
76,IA,19,129,"Mills County, Iowa",1300,667,633
77,IA,19,131,"Mitchell County, Iowa",1005,476,529
78,IA,19,133,"Monona County, Iowa",1233,529,704
79,IA,19,135,"Monroe County, Iowa",944,348,596
80,IA,19,137,"Montgomery County, Iowa",1717,715,1002
81,IA,19,139,"Muscatine County, Iowa",5219,2406,2813
82,IA,19,141,"O'Brien County, Iowa",1013,473,540
83,IA,19,143,"Osceola County, Iowa",521,192,329
84,IA,19,145,"Page County, Iowa",2262,1116,1146
85,IA,19,147,"Palo Alto County, Iowa",948,421,527
86,IA,19,149,"Plymouth County, Iowa",1907,817,1090
87,IA,19,151,"Pocahontas County, Iowa",987,458,529
88,IA,19,153,"Polk County, Iowa",57143,25452,31691
89,IA,19,155,"Pottawattamie County, Iowa",11779,5050,6729
90,IA,19,157,"Poweshiek County, Iowa",1767,731,1036
91,IA,19,159,"Ringgold County, Iowa",514,206,308
92,IA,19,161,"Sac County, Iowa",805,304,501
93,IA,19,163,"Scott County, Iowa",20229,8767,11462
94,IA,19,165,"Shelby County, Iowa",1307,600,707
95,IA,19,167,"Sioux County, Iowa",2663,1099,1564
96,IA,19,169,"Story County, Iowa",19109,10045,9064
97,IA,19,171,"Tama County, Iowa",1919,903,1016
98,IA,19,173,"Taylor County, Iowa",860,386,474
99,IA,19,175,"Union County, Iowa",1676,669,1007
100,IA,19,177,"Van Buren County, Iowa",1095,545,550
101,IA,19,179,"Wapello County, Iowa",6399,3090,3309
102,IA,19,181,"Warren County, Iowa",3124,1413,1711
103,IA,19,183,"Washington County, Iowa",2013,883,1130
104,IA,19,185,"Wayne County, Iowa",834,372,462
105,IA,19,187,"Webster County, Iowa",5210,2122,3088
106,IA,19,189,"Winnebago County, Iowa",995,465,530
107,IA,19,191,"Winneshiek County, Iowa",1507,676,831
108,IA,19,193,"Woodbury County, Iowa",14557,6122,8435
109,IA,19,195,"Worth County, Iowa",887,389,498
110,IA,19,197,"Wright County, Iowa",1412,649,763
12,ID,16,001,"Ada County, Idaho",50551,24218,26333
13,ID,16,003,"Adams County, Idaho",495,261,234
14,ID,16,005,"Bannock County, Idaho",15288,7053,8235
15,ID,16,007,"Bear Lake County, Idaho",759,352,407
16,ID,16,009,"Benewah County, Idaho",1490,695,795
17,ID,16,011,"Bingham County, Idaho",6093,2801,3292
18,ID,16,013,"Blaine County, Idaho",2218,989,1229
19,ID,16,015,"Boise County, Idaho",991,490,501
20,ID,16,017,"Bonner County, Idaho",6145,2946,3199
21,ID,16,019,"Bonneville County, Idaho",14025,6101,7924
22,ID,16,021,"Boundary County, Idaho",1647,774,873
23,ID,16,023,"Butte County, Idaho",460,241,219
24,ID,16,025,"Camas County, Idaho",229,101,128
25,ID,16,027,"Canyon County, Idaho",37945,17283,20662
26,ID,16,029,"Caribou County, Idaho",551,215,336
27,ID,16,031,"Cassia County, Idaho",3645,1616,2029
28,ID,16,033,"Clark County, Idaho",163,98,65
29,ID,16,035,"Clearwater County, Idaho",985,423,562
30,ID,16,037,"Custer County, Idaho",806,397,409
31,ID,16,039,"Elmore County, Idaho",4046,1773,2273
32,ID,16,041,"Franklin County, Idaho",1696,773,923
33,ID,16,043,"Fremont County, Idaho",1266,601,665
34,ID,16,045,"Gem County, Idaho",2980,1404,1576
35,ID,16,047,"Gooding County, Idaho",2911,1593,1318
36,ID,16,049,"Idaho County, Idaho",2528,1219,1309
37,ID,16,051,"Jefferson County, Idaho",3492,1558,1934
38,ID,16,053,"Jerome County, Idaho",3676,1577,2099
39,ID,16,055,"Kootenai County, Idaho",18634,8293,10341
40,ID,16,057,"Latah County, Idaho",7597,3909,3688
41,ID,16,059,"Lemhi County, Idaho",1430,657,773
42,ID,16,061,"Lewis County, Idaho",652,251,401
43,ID,16,063,"Lincoln County, Idaho",709,341,368
44,ID,16,065,"Madison County, Idaho",13232,6357,6875
45,ID,16,067,"Minidoka County, Idaho",3501,1562,1939
46,ID,16,069,"Nez Perce County, Idaho",4581,2166,2415
47,ID,16,071,"Oneida County, Idaho",615,292,323
48,ID,16,073,"Owyhee County, Idaho",3091,1580,1511
49,ID,16,075,"Payette County, Idaho",4152,1963,2189
50,ID,16,077,"Power County, Idaho",1034,353,681
51,ID,16,079,"Shoshone County, Idaho",2108,1006,1102
52,ID,16,081,"Teton County, Idaho",1110,441,669
53,ID,16,083,"Twin Falls County, Idaho",12418,5566,6852
54,ID,16,085,"Valley County, Idaho",1434,857,577
55,ID,16,087,"Washington County, Idaho",1798,886,912
12,IL,17,001,"Adams County, Illinois",9433,4259,5174
13,IL,17,003,"Alexander County, Illinois",2424,1018,1406
14,IL,17,005,"Bond County, Illinois",2593,1121,1472
15,IL,17,007,"Boone County, Illinois",5841,2237,3604
16,IL,17,009,"Brown County, Illinois",565,305,260
17,IL,17,011,"Bureau County, Illinois",4191,1800,2391
18,IL,17,013,"Calhoun County, Illinois",606,294,312
19,IL,17,015,"Carroll County, Illinois",1843,894,949
20,IL,17,017,"Cass County, Illinois",1688,775,913
21,IL,17,019,"Champaign County, Illinois",43284,21117,22167
22,IL,17,021,"Christian County, Illinois",4714,1953,2761
23,IL,17,023,"Clark County, Illinois",2360,995,1365
24,IL,17,025,"Clay County, Illinois",1839,719,1120
25,IL,17,027,"Clinton County, Illinois",3193,1251,1942
26,IL,17,029,"Coles County, Illinois",10951,4833,6118
27,IL,17,031,"Cook County, Illinois",879499,392713,486786
28,IL,17,033,"Crawford County, Illinois",2310,1127,1183
29,IL,17,035,"Cumberland County, Illinois",1700,755,945
30,IL,17,037,"DeKalb County, Illinois",18336,7881,10455
31,IL,17,039,"De Witt County, Illinois",2073,936,1137
32,IL,17,041,"Douglas County, Illinois",2019,829,1190
33,IL,17,043,"DuPage County, Illinois",67941,30099,37842
34,IL,17,045,"Edgar County, Illinois",2999,1370,1629
35,IL,17,047,"Edwards County, Illinois",851,364,487
36,IL,17,049,"Effingham County, Illinois",3557,1758,1799
37,IL,17,051,"Fayette County, Illinois",3644,1651,1993
38,IL,17,053,"Ford County, Illinois",1790,792,998
39,IL,17,055,"Franklin County, Illinois",7191,3279,3912
40,IL,17,057,"Fulton County, Illinois",4838,2193,2645
41,IL,17,059,"Gallatin County, Illinois",837,375,462
42,IL,17,061,"Greene County, Illinois",2231,994,1237
43,IL,17,063,"Grundy County, Illinois",4531,1897,2634
44,IL,17,065,"Hamilton County, Illinois",1211,565,646
45,IL,17,067,"Hancock County, Illinois",2159,950,1209
46,IL,17,069,"Hardin County, Illinois",864,355,509
47,IL,17,071,"Henderson County, Illinois",692,230,462
48,IL,17,073,"Henry County, Illinois",5256,2166,3090
49,IL,17,075,"Iroquois County, Illinois",4735,2010,2725
50,IL,17,077,"Jackson County, Illinois",16853,8533,8320
51,IL,17,079,"Jasper County, Illinois",881,319,562
52,IL,17,081,"Jefferson County, Illinois",6179,2740,3439
53,IL,17,083,"Jersey County, Illinois",1590,559,1031
54,IL,17,085,"Jo Daviess County, Illinois",2032,849,1183
55,IL,17,087,"Johnson County, Illinois",1589,761,828
56,IL,17,089,"Kane County, Illinois",59033,26663,32370
57,IL,17,091,"Kankakee County, Illinois",17365,7945,9420
58,IL,17,093,"Kendall County, Illinois",6616,2622,3994
59,IL,17,095,"Knox County, Illinois",9013,4050,4963
60,IL,17,097,"Lake County, Illinois",65728,30540,35188
61,IL,17,099,"LaSalle County, Illinois",14386,6252,8134
62,IL,17,101,"Lawrence County, Illinois",1509,549,960
63,IL,17,103,"Lee County, Illinois",3555,1680,1875
64,IL,17,105,"Livingston County, Illinois",3897,1699,2198
65,IL,17,107,"Logan County, Illinois",3303,1336,1967
66,IL,17,109,"McDonough County, Illinois",6394,2743,3651
67,IL,17,111,"McHenry County, Illinois",24037,11663,12374
68,IL,17,113,"McLean County, Illinois",23795,10918,12877
69,IL,17,115,"Macon County, Illinois",19411,8246,11165
70,IL,17,117,"Macoupin County, Illinois",5729,2375,3354
71,IL,17,119,"Madison County, Illinois",34818,15421,19397
72,IL,17,121,"Marion County, Illinois",6965,3100,3865
73,IL,17,123,"Marshall County, Illinois",1201,439,762
74,IL,17,125,"Mason County, Illinois",2095,919,1176
75,IL,17,127,"Massac County, Illinois",2705,1251,1454
76,IL,17,129,"Menard County, Illinois",1404,603,801
77,IL,17,131,"Mercer County, Illinois",1498,616,882
78,IL,17,133,"Monroe County, Illinois",1667,529,1138
79,IL,17,135,"Montgomery County, Illinois",3503,1170,2333
80,IL,17,137,"Morgan County, Illinois",4580,2222,2358
81,IL,17,139,"Moultrie County, Illinois",1929,1000,929
82,IL,17,141,"Ogle County, Illinois",5477,2460,3017
83,IL,17,143,"Peoria County, Illinois",31194,13602,17592
84,IL,17,145,"Perry County, Illinois",3380,1383,1997
85,IL,17,147,"Piatt County, Illinois",1019,398,621
86,IL,17,149,"Pike County, Illinois",2133,1011,1122
87,IL,17,151,"Pope County, Illinois",615,247,368
88,IL,17,153,"Pulaski County, Illinois",1178,529,649
89,IL,17,155,"Putnam County, Illinois",691,304,387
90,IL,17,157,"Randolph County, Illinois",3816,1716,2100
91,IL,17,159,"Richland County, Illinois",2382,1001,1381
92,IL,17,161,"Rock Island County, Illinois",21223,9137,12086
93,IL,17,163,"St. Clair County, Illinois",47946,20261,27685
94,IL,17,165,"Saline County, Illinois",5534,2362,3172
95,IL,17,167,"Sangamon County, Illinois",30297,13769,16528
96,IL,17,169,"Schuyler County, Illinois",1382,885,497
97,IL,17,171,"Scott County, Illinois",712,332,380
98,IL,17,173,"Shelby County, Illinois",2449,1159,1290
99,IL,17,175,"Stark County, Illinois",684,271,413
100,IL,17,177,"Stephenson County, Illinois",6849,2985,3864
101,IL,17,179,"Tazewell County, Illinois",11559,4787,6772
102,IL,17,181,"Union County, Illinois",2971,1495,1476
103,IL,17,183,"Vermilion County, Illinois",14571,6430,8141
104,IL,17,185,"Wabash County, Illinois",1447,617,830
105,IL,17,187,"Warren County, Illinois",2464,992,1472
106,IL,17,189,"Washington County, Illinois",1834,861,973
107,IL,17,191,"Wayne County, Illinois",2385,1052,1333
108,IL,17,193,"White County, Illinois",1916,825,1091
109,IL,17,195,"Whiteside County, Illinois",6740,2999,3741
110,IL,17,197,"Will County, Illinois",53482,22781,30701
111,IL,17,199,"Williamson County, Illinois",9783,4284,5499
112,IL,17,201,"Winnebago County, Illinois",47851,21483,26368
113,IL,17,203,"Woodford County, Illinois",3105,1461,1644
12,IN,18,001,"Adams County, Indiana",5529,2596,2933
13,IN,18,003,"Allen County, Indiana",56542,25163,31379
14,IN,18,005,"Bartholomew County, Indiana",10027,4645,5382
15,IN,18,007,"Benton County, Indiana",1181,512,669
16,IN,18,009,"Blackford County, Indiana",1700,664,1036
17,IN,18,011,"Boone County, Indiana",3498,1551,1947
18,IN,18,013,"Brown County, Indiana",1865,959,906
19,IN,18,015,"Carroll County, Indiana",2149,895,1254
20,IN,18,017,"Cass County, Indiana",5884,2717,3167
21,IN,18,019,"Clark County, Indiana",12009,5616,6393
22,IN,18,021,"Clay County, Indiana",3807,1695,2112
23,IN,18,023,"Clinton County, Indiana",4504,2018,2486
24,IN,18,025,"Crawford County, Indiana",2166,975,1191
25,IN,18,027,"Daviess County, Indiana",4192,1934,2258
26,IN,18,029,"Dearborn County, Indiana",4553,1982,2571
27,IN,18,031,"Decatur County, Indiana",3647,1518,2129
28,IN,18,033,"DeKalb County, Indiana",6107,2741,3366
29,IN,18,035,"Delaware County, Indiana",24209,10795,13414
30,IN,18,037,"Dubois County, Indiana",4071,1772,2299
31,IN,18,039,"Elkhart County, Indiana",31601,12817,18784
32,IN,18,041,"Fayette County, Indiana",4806,2129,2677
33,IN,18,043,"Floyd County, Indiana",9530,4041,5489
34,IN,18,045,"Fountain County, Indiana",1992,870,1122
35,IN,18,047,"Franklin County, Indiana",2413,1094,1319
36,IN,18,049,"Fulton County, Indiana",3011,1441,1570
37,IN,18,051,"Gibson County, Indiana",3675,1611,2064
38,IN,18,053,"Grant County, Indiana",11829,5068,6761
39,IN,18,055,"Greene County, Indiana",4398,1869,2529
40,IN,18,057,"Hamilton County, Indiana",13889,5730,8159
41,IN,18,059,"Hancock County, Indiana",4583,1738,2845
42,IN,18,061,"Harrison County, Indiana",5392,2399,2993
43,IN,18,063,"Hendricks County, Indiana",7514,2643,4871
44,IN,18,065,"Henry County, Indiana",7465,3105,4360
45,IN,18,067,"Howard County, Indiana",14445,6520,7925
46,IN,18,069,"Huntington County, Indiana",4241,1829,2412
47,IN,18,071,"Jackson County, Indiana",6297,2608,3689
48,IN,18,073,"Jasper County, Indiana",2710,1252,1458
49,IN,18,075,"Jay County, Indiana",3400,1570,1830
50,IN,18,077,"Jefferson County, Indiana",4343,1949,2394
51,IN,18,079,"Jennings County, Indiana",4390,2189,2201
52,IN,18,081,"Johnson County, Indiana",14205,6368,7837
53,IN,18,083,"Knox County, Indiana",5630,2479,3151
54,IN,18,085,"Kosciusko County, Indiana",8645,3964,4681
55,IN,18,087,"LaGrange County, Indiana",4909,2157,2752
56,IN,18,089,"Lake County, Indiana",87203,37304,49899
57,IN,18,091,"LaPorte County, Indiana",17792,7191,10601
58,IN,18,093,"Lawrence County, Indiana",5850,2758,3092
59,IN,18,095,"Madison County, Indiana",21089,9753,11336
60,IN,18,097,"Marion County, Indiana",191309,86399,104910
61,IN,18,099,"Marshall County, Indiana",5594,2265,3329
62,IN,18,101,"Martin County, Indiana",1320,532,788
63,IN,18,103,"Miami County, Indiana",5174,2271,2903
64,IN,18,105,"Monroe County, Indiana",31707,15337,16370
65,IN,18,107,"Montgomery County, Indiana",5153,2408,2745
66,IN,18,109,"Morgan County, Indiana",8237,3406,4831
67,IN,18,111,"Newton County, Indiana",1892,703,1189
68,IN,18,113,"Noble County, Indiana",5665,2582,3083
69,IN,18,115,"Ohio County, Indiana",470,219,251
70,IN,18,117,"Orange County, Indiana",3403,1562,1841
71,IN,18,119,"Owen County, Indiana",3172,1535,1637
72,IN,18,121,"Parke County, Indiana",2486,1103,1383
73,IN,18,123,"Perry County, Indiana",2276,1020,1256
74,IN,18,125,"Pike County, Indiana",1243,579,664
75,IN,18,127,"Porter County, Indiana",18850,8093,10757
76,IN,18,129,"Posey County, Indiana",2801,1480,1321
77,IN,18,131,"Pulaski County, Indiana",1808,707,1101
78,IN,18,133,"Putnam County, Indiana",3245,1391,1854
79,IN,18,135,"Randolph County, Indiana",4522,1782,2740
80,IN,18,137,"Ripley County, Indiana",2403,1042,1361
81,IN,18,139,"Rush County, Indiana",2946,1189,1757
82,IN,18,141,"St. Joseph County, Indiana",45532,19992,25540
83,IN,18,143,"Scott County, Indiana",4148,1896,2252
84,IN,18,145,"Shelby County, Indiana",5302,2258,3044
85,IN,18,147,"Spencer County, Indiana",2213,906,1307
86,IN,18,149,"Starke County, Indiana",3682,1634,2048
87,IN,18,151,"Steuben County, Indiana",3542,1577,1965
88,IN,18,153,"Sullivan County, Indiana",3534,1469,2065
89,IN,18,155,"Switzerland County, Indiana",2022,1025,997
90,IN,18,157,"Tippecanoe County, Indiana",36902,18433,18469
91,IN,18,159,"Tipton County, Indiana",1529,732,797
92,IN,18,161,"Union County, Indiana",754,372,382
93,IN,18,163,"Vanderburgh County, Indiana",28870,12815,16055
94,IN,18,165,"Vermillion County, Indiana",1996,896,1100
95,IN,18,167,"Vigo County, Indiana",20245,9199,11046
96,IN,18,169,"Wabash County, Indiana",4373,1771,2602
97,IN,18,171,"Warren County, Indiana",740,297,443
98,IN,18,173,"Warrick County, Indiana",5926,2551,3375
99,IN,18,175,"Washington County, Indiana",4190,1900,2290
100,IN,18,177,"Wayne County, Indiana",13732,6012,7720
101,IN,18,179,"Wells County, Indiana",3306,1449,1857
102,IN,18,181,"White County, Indiana",2309,1029,1280
103,IN,18,183,"Whitley County, Indiana",2633,1208,1425
12,KS,20,001,"Allen County, Kansas",2257,957,1300
13,KS,20,003,"Anderson County, Kansas",1362,668,694
14,KS,20,005,"Atchison County, Kansas",2970,1310,1660
15,KS,20,007,"Barber County, Kansas",511,245,266
16,KS,20,009,"Barton County, Kansas",4261,1840,2421
17,KS,20,011,"Bourbon County, Kansas",2757,1175,1582
18,KS,20,013,"Brown County, Kansas",1598,669,929
19,KS,20,015,"Butler County, Kansas",6620,2830,3790
20,KS,20,017,"Chase County, Kansas",360,164,196
21,KS,20,019,"Chautauqua County, Kansas",579,261,318
22,KS,20,021,"Cherokee County, Kansas",3511,1673,1838
23,KS,20,023,"Cheyenne County, Kansas",214,93,121
24,KS,20,025,"Clark County, Kansas",311,128,183
25,KS,20,027,"Clay County, Kansas",942,368,574
26,KS,20,029,"Cloud County, Kansas",1202,623,579
27,KS,20,031,"Coffey County, Kansas",833,425,408
28,KS,20,033,"Comanche County, Kansas",140,40,100
29,KS,20,035,"Cowley County, Kansas",5971,2742,3229
30,KS,20,037,"Crawford County, Kansas",8219,4161,4058
31,KS,20,039,"Decatur County, Kansas",316,108,208
32,KS,20,041,"Dickinson County, Kansas",2005,735,1270
33,KS,20,043,"Doniphan County, Kansas",892,444,448
34,KS,20,045,"Douglas County, Kansas",20137,10447,9690
35,KS,20,047,"Edwards County, Kansas",335,161,174
36,KS,20,049,"Elk County, Kansas",483,241,242
37,KS,20,051,"Ellis County, Kansas",4353,2259,2094
38,KS,20,053,"Ellsworth County, Kansas",484,171,313
39,KS,20,055,"Finney County, Kansas",6222,2572,3650
40,KS,20,057,"Ford County, Kansas",6183,3303,2880
41,KS,20,059,"Franklin County, Kansas",3264,1515,1749
42,KS,20,061,"Geary County, Kansas",4463,1978,2485
43,KS,20,063,"Gove County, Kansas",219,119,100
44,KS,20,065,"Graham County, Kansas",287,85,202
45,KS,20,067,"Grant County, Kansas",795,368,427
46,KS,20,069,"Gray County, Kansas",597,252,345
47,KS,20,071,"Greeley County, Kansas",97,38,59
48,KS,20,073,"Greenwood County, Kansas",945,408,537
49,KS,20,075,"Hamilton County, Kansas",371,137,234
50,KS,20,077,"Harper County, Kansas",933,443,490
51,KS,20,079,"Harvey County, Kansas",4415,1785,2630
52,KS,20,081,"Haskell County, Kansas",562,269,293
53,KS,20,083,"Hodgeman County, Kansas",88,44,44
54,KS,20,085,"Jackson County, Kansas",1197,414,783
55,KS,20,087,"Jefferson County, Kansas",1394,592,802
56,KS,20,089,"Jewell County, Kansas",466,200,266
57,KS,20,091,"Johnson County, Kansas",34556,14939,19617
58,KS,20,093,"Kearny County, Kansas",412,196,216
59,KS,20,095,"Kingman County, Kansas",811,289,522
60,KS,20,097,"Kiowa County, Kansas",364,177,187
61,KS,20,099,"Labette County, Kansas",3651,1642,2009
62,KS,20,101,"Lane County, Kansas",149,45,104
63,KS,20,103,"Leavenworth County, Kansas",8223,3686,4537
64,KS,20,105,"Lincoln County, Kansas",333,139,194
65,KS,20,107,"Linn County, Kansas",1246,607,639
66,KS,20,109,"Logan County, Kansas",232,98,134
67,KS,20,111,"Lyon County, Kansas",6919,3172,3747
68,KS,20,113,"McPherson County, Kansas",1993,704,1289
69,KS,20,115,"Marion County, Kansas",1306,620,686
70,KS,20,117,"Marshall County, Kansas",1087,407,680
71,KS,20,119,"Meade County, Kansas",481,174,307
72,KS,20,121,"Miami County, Kansas",2949,1213,1736
73,KS,20,123,"Mitchell County, Kansas",626,227,399
74,KS,20,125,"Montgomery County, Kansas",6303,2948,3355
75,KS,20,127,"Morris County, Kansas",505,229,276
76,KS,20,129,"Morton County, Kansas",325,151,174
77,KS,20,131,"Nemaha County, Kansas",1129,473,656
78,KS,20,133,"Neosho County, Kansas",2961,1306,1655
79,KS,20,135,"Ness County, Kansas",354,217,137
80,KS,20,137,"Norton County, Kansas",398,166,232
81,KS,20,139,"Osage County, Kansas",1997,852,1145
82,KS,20,141,"Osborne County, Kansas",564,232,332
83,KS,20,143,"Ottawa County, Kansas",466,217,249
84,KS,20,145,"Pawnee County, Kansas",464,179,285
85,KS,20,147,"Phillips County, Kansas",494,207,287
86,KS,20,149,"Pottawatomie County, Kansas",1992,859,1133
87,KS,20,151,"Pratt County, Kansas",1144,511,633
88,KS,20,153,"Rawlins County, Kansas",250,108,142
89,KS,20,155,"Reno County, Kansas",7457,3277,4180
90,KS,20,157,"Republic County, Kansas",599,248,351
91,KS,20,159,"Rice County, Kansas",1365,641,724
92,KS,20,161,"Riley County, Kansas",14922,7227,7695
93,KS,20,163,"Rooks County, Kansas",723,367,356
94,KS,20,165,"Rush County, Kansas",292,123,169
95,KS,20,167,"Russell County, Kansas",885,442,443
96,KS,20,169,"Saline County, Kansas",8700,3648,5052
97,KS,20,171,"Scott County, Kansas",319,104,215
98,KS,20,173,"Sedgwick County, Kansas",75400,34214,41186
99,KS,20,175,"Seward County, Kansas",4350,1771,2579
100,KS,20,177,"Shawnee County, Kansas",26445,12850,13595
101,KS,20,179,"Sheridan County, Kansas",165,49,116
102,KS,20,181,"Sherman County, Kansas",1125,605,520
103,KS,20,183,"Smith County, Kansas",543,207,336
104,KS,20,185,"Stafford County, Kansas",675,351,324
105,KS,20,187,"Stanton County, Kansas",113,41,72
106,KS,20,189,"Stevens County, Kansas",1037,423,614
107,KS,20,191,"Sumner County, Kansas",2869,1134,1735
108,KS,20,193,"Thomas County, Kansas",733,337,396
109,KS,20,195,"Trego County, Kansas",119,54,65
110,KS,20,197,"Wabaunsee County, Kansas",404,149,255
111,KS,20,199,"Wallace County, Kansas",129,54,75
112,KS,20,201,"Washington County, Kansas",649,265,384
113,KS,20,203,"Wichita County, Kansas",214,122,92
114,KS,20,205,"Wilson County, Kansas",1639,813,826
115,KS,20,207,"Woodson County, Kansas",714,328,386
116,KS,20,209,"Wyandotte County, Kansas",37963,17111,20852
12,KY,21,001,"Adair County, Kentucky",3789,1677,2112
13,KY,21,003,"Allen County, Kentucky",3454,1622,1832
14,KY,21,005,"Anderson County, Kentucky",2223,1071,1152
15,KY,21,007,"Ballard County, Kentucky",1295,521,774
16,KY,21,009,"Barren County, Kentucky",8598,3891,4707
17,KY,21,011,"Bath County, Kentucky",3122,1519,1603
18,KY,21,013,"Bell County, Kentucky",10233,4422,5811
19,KY,21,015,"Boone County, Kentucky",10156,4171,5985
20,KY,21,017,"Bourbon County, Kentucky",3272,1367,1905
21,KY,21,019,"Boyd County, Kentucky",9500,3956,5544
22,KY,21,021,"Boyle County, Kentucky",4291,1972,2319
23,KY,21,023,"Bracken County, Kentucky",1544,695,849
24,KY,21,025,"Breathitt County, Kentucky",4366,2095,2271
25,KY,21,027,"Breckinridge County, Kentucky",3422,1525,1897
26,KY,21,029,"Bullitt County, Kentucky",7911,3531,4380
27,KY,21,031,"Butler County, Kentucky",3667,1636,2031
28,KY,21,033,"Caldwell County, Kentucky",2544,1119,1425
29,KY,21,035,"Calloway County, Kentucky",8015,3642,4373
30,KY,21,037,"Campbell County, Kentucky",12883,5671,7212
31,KY,21,039,"Carlisle County, Kentucky",970,388,582
32,KY,21,041,"Carroll County, Kentucky",2898,1409,1489
33,KY,21,043,"Carter County, Kentucky",4682,2153,2529
34,KY,21,045,"Casey County, Kentucky",3969,1878,2091
35,KY,21,047,"Christian County, Kentucky",13576,5438,8138
36,KY,21,049,"Clark County, Kentucky",5401,2194,3207
37,KY,21,051,"Clay County, Kentucky",7732,3730,4002
38,KY,21,053,"Clinton County, Kentucky",2435,1078,1357
39,KY,21,055,"Crittenden County, Kentucky",1974,950,1024
40,KY,21,057,"Cumberland County, Kentucky",1682,652,1030
41,KY,21,059,"Daviess County, Kentucky",14948,6723,8225
42,KY,21,061,"Edmonson County, Kentucky",2296,971,1325
43,KY,21,063,"Elliott County, Kentucky",2079,1023,1056
44,KY,21,065,"Estill County, Kentucky",4199,1957,2242
45,KY,21,067,"Fayette County, Kentucky",55900,26117,29783
46,KY,21,069,"Fleming County, Kentucky",2907,1232,1675
47,KY,21,071,"Floyd County, Kentucky",11441,5471,5970
48,KY,21,073,"Franklin County, Kentucky",6990,3195,3795
49,KY,21,075,"Fulton County, Kentucky",1641,763,878
50,KY,21,077,"Gallatin County, Kentucky",1294,589,705
51,KY,21,079,"Garrard County, Kentucky",3653,1729,1924
52,KY,21,081,"Grant County, Kentucky",4445,1914,2531
53,KY,21,083,"Graves County, Kentucky",6342,2715,3627
54,KY,21,085,"Grayson County, Kentucky",6119,2731,3388
55,KY,21,087,"Green County, Kentucky",2216,1047,1169
56,KY,21,089,"Greenup County, Kentucky",6355,2848,3507
57,KY,21,091,"Hancock County, Kentucky",1360,654,706
58,KY,21,093,"Hardin County, Kentucky",14886,5818,9068
59,KY,21,095,"Harlan County, Kentucky",8661,3763,4898
60,KY,21,097,"Harrison County, Kentucky",4069,1749,2320
61,KY,21,099,"Hart County, Kentucky",4507,2082,2425
62,KY,21,101,"Henderson County, Kentucky",8602,3810,4792
63,KY,21,103,"Henry County, Kentucky",2798,1226,1572
64,KY,21,105,"Hickman County, Kentucky",675,284,391
65,KY,21,107,"Hopkins County, Kentucky",7799,3301,4498
66,KY,21,109,"Jackson County, Kentucky",4163,1963,2200
67,KY,21,111,"Jefferson County, Kentucky",121683,54397,67286
68,KY,21,113,"Jessamine County, Kentucky",9190,4128,5062
69,KY,21,115,"Johnson County, Kentucky",5977,2721,3256
70,KY,21,117,"Kenton County, Kentucky",23432,10164,13268
71,KY,21,119,"Knott County, Kentucky",4308,1935,2373
72,KY,21,121,"Knox County, Kentucky",10093,4551,5542
73,KY,21,123,"Larue County, Kentucky",2460,1058,1402
74,KY,21,125,"Laurel County, Kentucky",13588,6216,7372
75,KY,21,127,"Lawrence County, Kentucky",3548,1619,1929
76,KY,21,129,"Lee County, Kentucky",2003,952,1051
77,KY,21,131,"Leslie County, Kentucky",3051,1360,1691
78,KY,21,133,"Letcher County, Kentucky",6614,3158,3456
79,KY,21,135,"Lewis County, Kentucky",4151,1885,2266
80,KY,21,137,"Lincoln County, Kentucky",6039,2656,3383
81,KY,21,139,"Livingston County, Kentucky",1362,518,844
82,KY,21,141,"Logan County, Kentucky",5103,2411,2692
83,KY,21,143,"Lyon County, Kentucky",1002,340,662
84,KY,21,145,"McCracken County, Kentucky",10763,4614,6149
85,KY,21,147,"McCreary County, Kentucky",6723,3259,3464
86,KY,21,149,"McLean County, Kentucky",1983,1026,957
87,KY,21,151,"Madison County, Kentucky",16792,7821,8971
88,KY,21,153,"Magoffin County, Kentucky",3672,1659,2013
89,KY,21,155,"Marion County, Kentucky",3784,1646,2138
90,KY,21,157,"Marshall County, Kentucky",3287,1524,1763
91,KY,21,159,"Martin County, Kentucky",3896,1753,2143
92,KY,21,161,"Mason County, Kentucky",3087,1549,1538
93,KY,21,163,"Meade County, Kentucky",4810,2187,2623
94,KY,21,165,"Menifee County, Kentucky",1851,917,934
95,KY,21,167,"Mercer County, Kentucky",3862,1709,2153
96,KY,21,169,"Metcalfe County, Kentucky",2158,932,1226
97,KY,21,171,"Monroe County, Kentucky",2937,1363,1574
98,KY,21,173,"Montgomery County, Kentucky",6956,3141,3815
99,KY,21,175,"Morgan County, Kentucky",3249,1464,1785
100,KY,21,177,"Muhlenberg County, Kentucky",6000,2750,3250
101,KY,21,179,"Nelson County, Kentucky",7072,3347,3725
102,KY,21,181,"Nicholas County, Kentucky",1624,754,870
103,KY,21,183,"Ohio County, Kentucky",5208,2466,2742
104,KY,21,185,"Oldham County, Kentucky",3503,1271,2232
105,KY,21,187,"Owen County, Kentucky",1780,810,970
106,KY,21,189,"Owsley County, Kentucky",1710,810,900
107,KY,21,191,"Pendleton County, Kentucky",2188,875,1313
108,KY,21,193,"Perry County, Kentucky",6894,2903,3991
109,KY,21,195,"Pike County, Kentucky",14256,6146,8110
110,KY,21,197,"Powell County, Kentucky",3392,1361,2031
111,KY,21,199,"Pulaski County, Kentucky",16497,7900,8597
112,KY,21,201,"Robertson County, Kentucky",473,215,258
113,KY,21,203,"Rockcastle County, Kentucky",4105,1907,2198
114,KY,21,205,"Rowan County, Kentucky",5410,2340,3070
115,KY,21,207,"Russell County, Kentucky",4475,2055,2420
116,KY,21,209,"Scott County, Kentucky",5332,2152,3180
117,KY,21,211,"Shelby County, Kentucky",5566,2671,2895
118,KY,21,213,"Simpson County, Kentucky",3473,1486,1987
119,KY,21,215,"Spencer County, Kentucky",1466,577,889
120,KY,21,217,"Taylor County, Kentucky",5658,2390,3268
121,KY,21,219,"Todd County, Kentucky",2277,927,1350
122,KY,21,221,"Trigg County, Kentucky",2500,1030,1470
123,KY,21,223,"Trimble County, Kentucky",1486,737,749
124,KY,21,225,"Union County, Kentucky",4091,2171,1920
125,KY,21,227,"Warren County, Kentucky",21047,9159,11888
126,KY,21,229,"Washington County, Kentucky",2034,969,1065
127,KY,21,231,"Wayne County, Kentucky",5477,2505,2972
128,KY,21,233,"Webster County, Kentucky",2296,1117,1179
129,KY,21,235,"Whitley County, Kentucky",8871,4030,4841
130,KY,21,237,"Wolfe County, Kentucky",3058,1537,1521
131,KY,21,239,"Woodford County, Kentucky",3259,1279,1980
12,LA,22,001,"Acadia Parish, Louisiana",12539,4702,7837
13,LA,22,003,"Allen Parish, Louisiana",3501,1568,1933
14,LA,22,005,"Ascension Parish, Louisiana",13447,5551,7896
15,LA,22,007,"Assumption Parish, Louisiana",3643,1673,1970
16,LA,22,009,"Avoyelles Parish, Louisiana",8750,3408,5342
17,LA,22,011,"Beauregard Parish, Louisiana",7137,3103,4034
18,LA,22,013,"Bienville Parish, Louisiana",3754,1397,2357
19,LA,22,015,"Bossier Parish, Louisiana",17303,7402,9901
20,LA,22,017,"Caddo Parish, Louisiana",53752,23393,30359
21,LA,22,019,"Calcasieu Parish, Louisiana",32864,13822,19042
22,LA,22,021,"Caldwell Parish, Louisiana",2053,876,1177
23,LA,22,023,"Cameron Parish, Louisiana",650,317,333
24,LA,22,025,"Catahoula Parish, Louisiana",1890,872,1018
25,LA,22,027,"Claiborne Parish, Louisiana",4058,2023,2035
26,LA,22,029,"Concordia Parish, Louisiana",5598,2400,3198
27,LA,22,031,"De Soto Parish, Louisiana",7059,3061,3998
28,LA,22,033,"East Baton Rouge Parish, Louisiana",85254,37081,48173
29,LA,22,035,"East Carroll Parish, Louisiana",2903,1374,1529
30,LA,22,037,"East Feliciana Parish, Louisiana",3317,1569,1748
31,LA,22,039,"Evangeline Parish, Louisiana",8373,3718,4655
32,LA,22,041,"Franklin Parish, Louisiana",5847,2294,3553
33,LA,22,043,"Grant Parish, Louisiana",3460,1459,2001
34,LA,22,045,"Iberia Parish, Louisiana",14277,6094,8183
35,LA,22,047,"Iberville Parish, Louisiana",5612,2473,3139
36,LA,22,049,"Jackson Parish, Louisiana",3981,1799,2182
37,LA,22,051,"Jefferson Parish, Louisiana",72319,30773,41546
38,LA,22,053,"Jefferson Davis Parish, Louisiana",6462,2713,3749
39,LA,22,055,"Lafayette Parish, Louisiana",36346,15225,21121
40,LA,22,057,"Lafourche Parish, Louisiana",14117,5730,8387
41,LA,22,059,"LaSalle Parish, Louisiana",2857,1184,1673
42,LA,22,061,"Lincoln Parish, Louisiana",14146,6360,7786
43,LA,22,063,"Livingston Parish, Louisiana",19086,7960,11126
44,LA,22,065,"Madison Parish, Louisiana",3962,1840,2122
45,LA,22,067,"Morehouse Parish, Louisiana",7432,3212,4220
46,LA,22,069,"Natchitoches Parish, Louisiana",11208,4921,6287
47,LA,22,071,"Orleans Parish, Louisiana",98823,42998,55825
48,LA,22,073,"Ouachita Parish, Louisiana",36312,14458,21854
49,LA,22,075,"Plaquemines Parish, Louisiana",3775,1348,2427
50,LA,22,077,"Pointe Coupee Parish, Louisiana",4368,1876,2492
51,LA,22,079,"Rapides Parish, Louisiana",26645,11724,14921
52,LA,22,081,"Red River Parish, Louisiana",1937,803,1134
53,LA,22,083,"Richland Parish, Louisiana",4154,1825,2329
54,LA,22,085,"Sabine Parish, Louisiana",4626,1836,2790
55,LA,22,087,"St. Bernard Parish, Louisiana",8209,3529,4680
56,LA,22,089,"St. Charles Parish, Louisiana",6152,2412,3740
57,LA,22,091,"St. Helena Parish, Louisiana",2854,1309,1545
58,LA,22,093,"St. James Parish, Louisiana",3841,1845,1996
59,LA,22,095,"St. John the Baptist Parish, Louisiana",7893,3390,4503
60,LA,22,097,"St. Landry Parish, Louisiana",22970,9790,13180
61,LA,22,099,"St. Martin Parish, Louisiana",9388,3920,5468
62,LA,22,101,"St. Mary Parish, Louisiana",11746,4967,6779
63,LA,22,103,"St. Tammany Parish, Louisiana",27482,11568,15914
64,LA,22,105,"Tangipahoa Parish, Louisiana",26962,11734,15228
65,LA,22,107,"Tensas Parish, Louisiana",1685,731,954
66,LA,22,109,"Terrebonne Parish, Louisiana",21627,9182,12445
67,LA,22,111,"Union Parish, Louisiana",6166,2682,3484
68,LA,22,113,"Vermilion Parish, Louisiana",10379,4185,6194
69,LA,22,115,"Vernon Parish, Louisiana",7403,3280,4123
70,LA,22,117,"Washington Parish, Louisiana",11811,5364,6447
71,LA,22,119,"Webster Parish, Louisiana",9327,4117,5210
72,LA,22,121,"West Baton Rouge Parish, Louisiana",4662,1883,2779
73,LA,22,123,"West Carroll Parish, Louisiana",2746,1066,1680
74,LA,22,125,"West Feliciana Parish, Louisiana",1914,1016,898
75,LA,22,127,"Winn Parish, Louisiana",3466,1506,1960
12,MA,25,001,"Barnstable County, Massachusetts",18392,8191,10201
13,MA,25,003,"Berkshire County, Massachusetts",16038,6834,9204
14,MA,25,005,"Bristol County, Massachusetts",68016,29385,38631
15,MA,25,007,"Dukes County, Massachusetts",1970,802,1168
16,MA,25,009,"Essex County, Massachusetts",85417,35457,49960
17,MA,25,011,"Franklin County, Massachusetts",8210,3508,4702
18,MA,25,013,"Hampden County, Massachusetts",79308,34517,44791
19,MA,25,015,"Hampshire County, Massachusetts",20317,9564,10753
20,MA,25,017,"Middlesex County, Massachusetts",124958,53601,71357
21,MA,25,019,"Nantucket County, Massachusetts",1205,657,548
22,MA,25,021,"Norfolk County, Massachusetts",44199,17778,26421
23,MA,25,023,"Plymouth County, Massachusetts",40309,17589,22720
24,MA,25,025,"Suffolk County, Massachusetts",148278,64005,84273
25,MA,25,027,"Worcester County, Massachusetts",92288,40222,52066
12,MD,24,001,"Allegany County, Maryland",11927,5722,6205
13,MD,24,003,"Anne Arundel County, Maryland",31573,13598,17975
14,MD,24,005,"Baltimore County, Maryland",75464,30881,44583
15,MD,24,009,"Calvert County, Maryland",5207,2044,3163
16,MD,24,011,"Caroline County, Maryland",5086,2254,2832
17,MD,24,013,"Carroll County, Maryland",9205,4085,5120
18,MD,24,015,"Cecil County, Maryland",10179,4664,5515
19,MD,24,017,"Charles County, Maryland",11905,4933,6972
20,MD,24,019,"Dorchester County, Maryland",5275,2146,3129
21,MD,24,021,"Frederick County, Maryland",16204,7194,9010
22,MD,24,023,"Garrett County, Maryland",3615,1673,1942
23,MD,24,025,"Harford County, Maryland",19854,8342,11512
24,MD,24,027,"Howard County, Maryland",15759,6684,9075
25,MD,24,029,"Kent County, Maryland",2051,825,1226
26,MD,24,031,"Montgomery County, Maryland",67820,28612,39208
27,MD,24,033,"Prince George's County, Maryland",84018,36085,47933
28,MD,24,035,"Queen Anne's County, Maryland",3588,1721,1867
29,MD,24,037,"St. Mary's County, Maryland",8384,3098,5286
30,MD,24,039,"Somerset County, Maryland",4681,1834,2847
31,MD,24,041,"Talbot County, Maryland",4202,1493,2709
32,MD,24,043,"Washington County, Maryland",18094,7436,10658
33,MD,24,045,"Wicomico County, Maryland",15493,6604,8889
34,MD,24,047,"Worcester County, Maryland",5567,2436,3131
35,MD,24,510,"Baltimore city, Maryland",141654,62133,79521
12,ME,23,001,"Androscoggin County, Maine",16332,7347,8985
13,ME,23,003,"Aroostook County, Maine",12608,5761,6847
14,ME,23,005,"Cumberland County, Maine",32339,15055,17284
15,ME,23,007,"Franklin County, Maine",4318,1971,2347
16,ME,23,009,"Hancock County, Maine",7196,3075,4121
17,ME,23,011,"Kennebec County, Maine",16256,7316,8940
18,ME,23,013,"Knox County, Maine",4304,2232,2072
19,ME,23,015,"Lincoln County, Maine",4073,1809,2264
20,ME,23,017,"Oxford County, Maine",9911,4357,5554
21,ME,23,019,"Penobscot County, Maine",24933,11157,13776
22,ME,23,021,"Piscataquis County, Maine",3520,1643,1877
23,ME,23,023,"Sagadahoc County, Maine",4200,1710,2490
24,ME,23,025,"Somerset County, Maine",8907,4162,4745
25,ME,23,027,"Waldo County, Maine",6243,2895,3348
26,ME,23,029,"Washington County, Maine",5946,2598,3348
27,ME,23,031,"York County, Maine",19192,7672,11520
12,MI,26,001,"Alcona County, Michigan",1575,709,866
13,MI,26,003,"Alger County, Michigan",1213,635,578
14,MI,26,005,"Allegan County, Michigan",14185,6447,7738
15,MI,26,007,"Alpena County, Michigan",4898,2193,2705
16,MI,26,009,"Antrim County, Michigan",3316,1451,1865
17,MI,26,011,"Arenac County, Michigan",3013,1512,1501
18,MI,26,013,"Baraga County, Michigan",992,423,569
19,MI,26,015,"Barry County, Michigan",6377,2907,3470
20,MI,26,017,"Bay County, Michigan",15804,7485,8319
21,MI,26,019,"Benzie County, Michigan",1989,936,1053
22,MI,26,021,"Berrien County, Michigan",26719,11545,15174
23,MI,26,023,"Branch County, Michigan",7310,3527,3783
24,MI,26,025,"Calhoun County, Michigan",22931,10265,12666
25,MI,26,027,"Cass County, Michigan",7576,3689,3887
26,MI,26,029,"Charlevoix County, Michigan",3181,1431,1750
27,MI,26,031,"Cheboygan County, Michigan",4595,2023,2572
28,MI,26,033,"Chippewa County, Michigan",6485,3312,3173
29,MI,26,035,"Clare County, Michigan",7895,3545,4350
30,MI,26,037,"Clinton County, Michigan",8933,4098,4835
31,MI,26,039,"Crawford County, Michigan",2073,977,1096
32,MI,26,041,"Delta County, Michigan",6227,2966,3261
33,MI,26,043,"Dickinson County, Michigan",3523,1489,2034
34,MI,26,045,"Eaton County, Michigan",11524,5064,6460
35,MI,26,047,"Emmet County, Michigan",3506,1504,2002
36,MI,26,049,"Genesee County, Michigan",85696,38849,46847
37,MI,26,051,"Gladwin County, Michigan",5211,2382,2829
38,MI,26,053,"Gogebic County, Michigan",2859,1339,1520
39,MI,26,055,"Grand Traverse County, Michigan",9575,4520,5055
40,MI,26,057,"Gratiot County, Michigan",6792,2868,3924
41,MI,26,059,"Hillsdale County, Michigan",8982,4302,4680
42,MI,26,061,"Houghton County, Michigan",7406,4283,3123
43,MI,26,063,"Huron County, Michigan",4486,2093,2393
44,MI,26,065,"Ingham County, Michigan",59468,27305,32163
45,MI,26,067,"Ionia County, Michigan",9084,4395,4689
46,MI,26,069,"Iosco County, Michigan",4395,2005,2390
47,MI,26,071,"Iron County, Michigan",1749,875,874
48,MI,26,073,"Isabella County, Michigan",19390,9228,10162
49,MI,26,075,"Jackson County, Michigan",25464,11251,14213
50,MI,26,077,"Kalamazoo County, Michigan",45473,20808,24665
51,MI,26,079,"Kalkaska County, Michigan",2875,1379,1496
52,MI,26,081,"Kent County, Michigan",93489,42845,50644
53,MI,26,083,"Keweenaw County, Michigan",336,169,167
54,MI,26,085,"Lake County, Michigan",3164,1509,1655
55,MI,26,087,"Lapeer County, Michigan",9152,4261,4891
56,MI,26,089,"Leelanau County, Michigan",2245,1099,1146
57,MI,26,091,"Lenawee County, Michigan",13427,6044,7383
58,MI,26,093,"Livingston County, Michigan",10895,4813,6082
59,MI,26,095,"Luce County, Michigan",1059,453,606
60,MI,26,097,"Mackinac County, Michigan",1730,818,912
61,MI,26,099,"Macomb County, Michigan",106546,46437,60109
62,MI,26,101,"Manistee County, Michigan",3918,1767,2151
63,MI,26,103,"Marquette County, Michigan",10689,4951,5738
64,MI,26,105,"Mason County, Michigan",4861,2242,2619
65,MI,26,107,"Mecosta County, Michigan",9338,4257,5081
66,MI,26,109,"Menominee County, Michigan",3774,1517,2257
67,MI,26,111,"Midland County, Michigan",10955,4988,5967
68,MI,26,113,"Missaukee County, Michigan",2490,1153,1337
69,MI,26,115,"Monroe County, Michigan",16860,7388,9472
70,MI,26,117,"Montcalm County, Michigan",10924,4760,6164
71,MI,26,119,"Montmorency County, Michigan",1568,611,957
72,MI,26,121,"Muskegon County, Michigan",31550,14092,17458
73,MI,26,123,"Newaygo County, Michigan",8605,3978,4627
74,MI,26,125,"Oakland County, Michigan",123086,54727,68359
75,MI,26,127,"Oceana County, Michigan",5285,2524,2761
76,MI,26,129,"Ogemaw County, Michigan",4537,2019,2518
77,MI,26,131,"Ontonagon County, Michigan",967,464,503
78,MI,26,133,"Osceola County, Michigan",5032,2248,2784
79,MI,26,135,"Oscoda County, Michigan",1656,770,886
80,MI,26,137,"Otsego County, Michigan",3270,1318,1952
81,MI,26,139,"Ottawa County, Michigan",27361,12381,14980
82,MI,26,141,"Presque Isle County, Michigan",1761,792,969
83,MI,26,143,"Roscommon County, Michigan",4885,2222,2663
84,MI,26,145,"Saginaw County, Michigan",34825,15792,19033
85,MI,26,147,"St. Clair County, Michigan",23128,10571,12557
86,MI,26,149,"St. Joseph County, Michigan",10319,4684,5635
87,MI,26,151,"Sanilac County, Michigan",6522,2816,3706
88,MI,26,153,"Schoolcraft County, Michigan",1735,831,904
89,MI,26,155,"Shiawassee County, Michigan",9790,4325,5465
90,MI,26,157,"Tuscola County, Michigan",8317,3963,4354
91,MI,26,159,"Van Buren County, Michigan",14029,6400,7629
92,MI,26,161,"Washtenaw County, Michigan",51965,25329,26636
93,MI,26,163,"Wayne County, Michigan",440449,200486,239963
94,MI,26,165,"Wexford County, Michigan",5631,2846,2785
12,MN,27,001,"Aitkin County, Minnesota",1937,960,977
13,MN,27,003,"Anoka County, Minnesota",25925,12012,13913
14,MN,27,005,"Becker County, Minnesota",4160,1754,2406
15,MN,27,007,"Beltrami County, Minnesota",8118,3825,4293
16,MN,27,009,"Benton County, Minnesota",5732,2314,3418
17,MN,27,011,"Big Stone County, Minnesota",719,260,459
18,MN,27,013,"Blue Earth County, Minnesota",11745,5827,5918
19,MN,27,015,"Brown County, Minnesota",1887,931,956
20,MN,27,017,"Carlton County, Minnesota",4727,2502,2225
21,MN,27,019,"Carver County, Minnesota",4172,1886,2286
22,MN,27,021,"Cass County, Minnesota",4656,2195,2461
23,MN,27,023,"Chippewa County, Minnesota",1454,571,883
24,MN,27,025,"Chisago County, Minnesota",2889,1389,1500
25,MN,27,027,"Clay County, Minnesota",7202,3333,3869
26,MN,27,029,"Clearwater County, Minnesota",1451,704,747
27,MN,27,031,"Cook County, Minnesota",588,242,346
28,MN,27,033,"Cottonwood County, Minnesota",1905,862,1043
29,MN,27,035,"Crow Wing County, Minnesota",7028,3396,3632
30,MN,27,037,"Dakota County, Minnesota",31270,13735,17535
31,MN,27,039,"Dodge County, Minnesota",1342,575,767
32,MN,27,041,"Douglas County, Minnesota",3438,1671,1767
33,MN,27,043,"Faribault County, Minnesota",1878,814,1064
34,MN,27,045,"Fillmore County, Minnesota",2280,1062,1218
35,MN,27,047,"Freeborn County, Minnesota",3679,1371,2308
36,MN,27,049,"Goodhue County, Minnesota",5104,2254,2850
37,MN,27,051,"Grant County, Minnesota",533,209,324
38,MN,27,053,"Hennepin County, Minnesota",146382,68632,77750
39,MN,27,055,"Houston County, Minnesota",2031,1013,1018
40,MN,27,057,"Hubbard County, Minnesota",2368,1092,1276
41,MN,27,059,"Isanti County, Minnesota",2802,1404,1398
42,MN,27,061,"Itasca County, Minnesota",6018,2849,3169
43,MN,27,063,"Jackson County, Minnesota",1085,524,561
44,MN,27,065,"Kanabec County, Minnesota",2242,1011,1231
45,MN,27,067,"Kandiyohi County, Minnesota",4877,2120,2757
46,MN,27,069,"Kittson County, Minnesota",474,179,295
47,MN,27,071,"Koochiching County, Minnesota",1937,956,981
48,MN,27,073,"Lac qui Parle County, Minnesota",561,250,311
49,MN,27,075,"Lake County, Minnesota",1364,687,677
50,MN,27,077,"Lake of the Woods County, Minnesota",363,162,201
51,MN,27,079,"Le Sueur County, Minnesota",2482,1203,1279
52,MN,27,081,"Lincoln County, Minnesota",524,207,317
53,MN,27,083,"Lyon County, Minnesota",3456,1351,2105
54,MN,27,085,"McLeod County, Minnesota",2866,1279,1587
55,MN,27,087,"Mahnomen County, Minnesota",1350,638,712
56,MN,27,089,"Marshall County, Minnesota",734,286,448
57,MN,27,091,"Martin County, Minnesota",2286,870,1416
58,MN,27,093,"Meeker County, Minnesota",2282,951,1331
59,MN,27,095,"Mille Lacs County, Minnesota",3080,1382,1698
60,MN,27,097,"Morrison County, Minnesota",3687,1602,2085
61,MN,27,099,"Mower County, Minnesota",5410,2667,2743
62,MN,27,101,"Murray County, Minnesota",771,335,436
63,MN,27,103,"Nicollet County, Minnesota",3814,1884,1930
64,MN,27,105,"Nobles County, Minnesota",3320,1569,1751
65,MN,27,107,"Norman County, Minnesota",846,383,463
66,MN,27,109,"Olmsted County, Minnesota",13237,5835,7402
67,MN,27,111,"Otter Tail County, Minnesota",5635,2449,3186
68,MN,27,113,"Pennington County, Minnesota",1286,567,719
69,MN,27,115,"Pine County, Minnesota",4015,1890,2125
70,MN,27,117,"Pipestone County, Minnesota",1182,449,733
71,MN,27,119,"Polk County, Minnesota",3987,1987,2000
72,MN,27,121,"Pope County, Minnesota",1011,431,580
73,MN,27,123,"Ramsey County, Minnesota",84589,38727,45862
74,MN,27,125,"Red Lake County, Minnesota",431,206,225
75,MN,27,127,"Redwood County, Minnesota",1825,900,925
76,MN,27,129,"Renville County, Minnesota",1646,676,970
77,MN,27,131,"Rice County, Minnesota",6469,2720,3749
78,MN,27,133,"Rock County, Minnesota",1067,431,636
79,MN,27,135,"Roseau County, Minnesota",1637,749,888
80,MN,27,137,"St. Louis County, Minnesota",30869,14248,16621
81,MN,27,139,"Scott County, Minnesota",7747,3527,4220
82,MN,27,141,"Sherburne County, Minnesota",6966,2952,4014
83,MN,27,143,"Sibley County, Minnesota",1584,699,885
84,MN,27,145,"Stearns County, Minnesota",19570,9275,10295
85,MN,27,147,"Steele County, Minnesota",3721,1400,2321
86,MN,27,149,"Stevens County, Minnesota",1727,895,832
87,MN,27,151,"Swift County, Minnesota",1167,397,770
88,MN,27,153,"Todd County, Minnesota",3548,1677,1871
89,MN,27,155,"Traverse County, Minnesota",341,139,202
90,MN,27,157,"Wabasha County, Minnesota",1547,742,805
91,MN,27,159,"Wadena County, Minnesota",2211,979,1232
92,MN,27,161,"Waseca County, Minnesota",1544,752,792
93,MN,27,163,"Washington County, Minnesota",13109,5830,7279
94,MN,27,165,"Watonwan County, Minnesota",1182,351,831
95,MN,27,167,"Wilkin County, Minnesota",627,219,408
96,MN,27,169,"Winona County, Minnesota",6933,3476,3457
97,MN,27,171,"Wright County, Minnesota",7846,3355,4491
98,MN,27,173,"Yellow Medicine County, Minnesota",1175,588,587
12,MO,29,001,"Adair County, Missouri",6105,2917,3188
13,MO,29,003,"Andrew County, Missouri",1531,828,703
14,MO,29,005,"Atchison County, Missouri",693,298,395
15,MO,29,007,"Audrain County, Missouri",4401,2030,2371
16,MO,29,009,"Barry County, Missouri",7072,3303,3769
17,MO,29,011,"Barton County, Missouri",2910,1329,1581
18,MO,29,013,"Bates County, Missouri",2996,1355,1641
19,MO,29,015,"Benton County, Missouri",3540,1492,2048
20,MO,29,017,"Bollinger County, Missouri",2654,1198,1456
21,MO,29,019,"Boone County, Missouri",31824,14224,17600
22,MO,29,021,"Buchanan County, Missouri",15456,7270,8186
23,MO,29,023,"Butler County, Missouri",8942,3780,5162
24,MO,29,025,"Caldwell County, Missouri",1186,487,699
25,MO,29,027,"Callaway County, Missouri",5865,2577,3288
26,MO,29,029,"Camden County, Missouri",7516,3496,4020
27,MO,29,031,"Cape Girardeau County, Missouri",13626,6203,7423
28,MO,29,033,"Carroll County, Missouri",1273,555,718
29,MO,29,035,"Carter County, Missouri",1319,613,706
30,MO,29,037,"Cass County, Missouri",9805,3862,5943
31,MO,29,039,"Cedar County, Missouri",3381,1827,1554
32,MO,29,041,"Chariton County, Missouri",1213,572,641
33,MO,29,043,"Christian County, Missouri",8879,3800,5079
34,MO,29,045,"Clark County, Missouri",928,459,469
35,MO,29,047,"Clay County, Missouri",20137,9091,11046
36,MO,29,049,"Clinton County, Missouri",1856,763,1093
37,MO,29,051,"Cole County, Missouri",9237,4466,4771
38,MO,29,053,"Cooper County, Missouri",2354,1129,1225
39,MO,29,055,"Crawford County, Missouri",5093,2385,2708
40,MO,29,057,"Dade County, Missouri",1473,738,735
41,MO,29,059,"Dallas County, Missouri",3577,1685,1892
42,MO,29,061,"Daviess County, Missouri",1340,567,773
43,MO,29,063,"DeKalb County, Missouri",1391,636,755
44,MO,29,065,"Dent County, Missouri",3642,1575,2067
45,MO,29,067,"Douglas County, Missouri",2941,1441,1500
46,MO,29,069,"Dunklin County, Missouri",8536,3850,4686
47,MO,29,071,"Franklin County, Missouri",11941,5839,6102
48,MO,29,073,"Gasconade County, Missouri",2316,1157,1159
49,MO,29,075,"Gentry County, Missouri",1119,497,622
50,MO,29,077,"Greene County, Missouri",51533,22824,28709
51,MO,29,079,"Grundy County, Missouri",2020,900,1120
52,MO,29,081,"Harrison County, Missouri",1485,676,809
53,MO,29,083,"Henry County, Missouri",4131,1852,2279
54,MO,29,085,"Hickory County, Missouri",2394,992,1402
55,MO,29,087,"Holt County, Missouri",555,269,286
56,MO,29,089,"Howard County, Missouri",1587,768,819
57,MO,29,091,"Howell County, Missouri",9158,4270,4888
58,MO,29,093,"Iron County, Missouri",2293,1090,1203
59,MO,29,095,"Jackson County, Missouri",119678,53111,66567
60,MO,29,097,"Jasper County, Missouri",19556,8607,10949
61,MO,29,099,"Jefferson County, Missouri",23937,11024,12913
62,MO,29,101,"Johnson County, Missouri",8407,4131,4276
63,MO,29,103,"Knox County, Missouri",823,384,439
64,MO,29,105,"Laclede County, Missouri",6816,3199,3617
65,MO,29,107,"Lafayette County, Missouri",3706,1584,2122
66,MO,29,109,"Lawrence County, Missouri",7052,3252,3800
67,MO,29,111,"Lewis County, Missouri",1215,532,683
68,MO,29,113,"Lincoln County, Missouri",7980,3595,4385
69,MO,29,115,"Linn County, Missouri",2196,1008,1188
70,MO,29,117,"Livingston County, Missouri",2273,954,1319
71,MO,29,119,"McDonald County, Missouri",4876,2218,2658
72,MO,29,121,"Macon County, Missouri",2895,1311,1584
73,MO,29,123,"Madison County, Missouri",2238,888,1350
74,MO,29,125,"Maries County, Missouri",1721,883,838
75,MO,29,127,"Marion County, Missouri",5020,2181,2839
76,MO,29,129,"Mercer County, Missouri",584,269,315
77,MO,29,131,"Miller County, Missouri",4942,2218,2724
78,MO,29,133,"Mississippi County, Missouri",3642,1370,2272
79,MO,29,135,"Moniteau County, Missouri",1885,896,989
80,MO,29,137,"Monroe County, Missouri",1260,621,639
81,MO,29,139,"Montgomery County, Missouri",2025,923,1102
82,MO,29,141,"Morgan County, Missouri",4757,2515,2242
83,MO,29,143,"New Madrid County, Missouri",4094,1799,2295
84,MO,29,145,"Newton County, Missouri",8377,3814,4563
85,MO,29,147,"Nodaway County, Missouri",5682,2463,3219
86,MO,29,149,"Oregon County, Missouri",2824,1355,1469
87,MO,29,151,"Osage County, Missouri",1139,603,536
88,MO,29,153,"Ozark County, Missouri",2292,1023,1269
89,MO,29,155,"Pemiscot County, Missouri",5068,2070,2998
90,MO,29,157,"Perry County, Missouri",1798,765,1033
91,MO,29,159,"Pettis County, Missouri",7484,3292,4192
92,MO,29,161,"Phelps County, Missouri",8137,4289,3848
93,MO,29,163,"Pike County, Missouri",2482,1017,1465
94,MO,29,165,"Platte County, Missouri",7106,2824,4282
95,MO,29,167,"Polk County, Missouri",5515,2420,3095
96,MO,29,169,"Pulaski County, Missouri",5781,2598,3183
97,MO,29,171,"Putnam County, Missouri",926,444,482
98,MO,29,173,"Ralls County, Missouri",1254,511,743
99,MO,29,175,"Randolph County, Missouri",4395,1944,2451
100,MO,29,177,"Ray County, Missouri",3598,1755,1843
101,MO,29,179,"Reynolds County, Missouri",1361,658,703
102,MO,29,181,"Ripley County, Missouri",3167,1376,1791
103,MO,29,183,"St. Charles County, Missouri",23022,10046,12976
104,MO,29,185,"St. Clair County, Missouri",2156,1042,1114
105,MO,29,186,"Ste. Genevieve County, Missouri",2540,925,1615
106,MO,29,187,"St. Francois County, Missouri",11138,4933,6205
107,MO,29,189,"St. Louis County, Missouri",106821,44437,62384
108,MO,29,195,"Saline County, Missouri",3808,1786,2022
109,MO,29,197,"Schuyler County, Missouri",914,407,507
110,MO,29,199,"Scotland County, Missouri",730,279,451
111,MO,29,201,"Scott County, Missouri",7492,3283,4209
112,MO,29,203,"Shannon County, Missouri",1938,808,1130
113,MO,29,205,"Shelby County, Missouri",1092,466,626
114,MO,29,207,"Stoddard County, Missouri",4583,1898,2685
115,MO,29,209,"Stone County, Missouri",5147,2154,2993
116,MO,29,211,"Sullivan County, Missouri",1066,407,659
117,MO,29,213,"Taney County, Missouri",9825,4609,5216
118,MO,29,215,"Texas County, Missouri",5214,2506,2708
119,MO,29,217,"Vernon County, Missouri",3764,1645,2119
120,MO,29,219,"Warren County, Missouri",4507,2131,2376
121,MO,29,221,"Washington County, Missouri",5030,2223,2807
122,MO,29,223,"Wayne County, Missouri",2960,1342,1618
123,MO,29,225,"Webster County, Missouri",6733,3198,3535
124,MO,29,227,"Worth County, Missouri",294,127,167
125,MO,29,229,"Wright County, Missouri",4594,2173,2421
126,MO,29,510,"St. Louis city, Missouri",83416,37160,46256
12,MS,28,001,"Adams County, Mississippi",8898,3858,5040
13,MS,28,003,"Alcorn County, Mississippi",7752,3445,4307
14,MS,28,005,"Amite County, Mississippi",2852,1314,1538
15,MS,28,007,"Attala County, Mississippi",4908,1796,3112
16,MS,28,009,"Benton County, Mississippi",1764,886,878
17,MS,28,011,"Bolivar County, Mississippi",11900,5142,6758
18,MS,28,013,"Calhoun County, Mississippi",3763,1682,2081
19,MS,28,015,"Carroll County, Mississippi",2086,839,1247
20,MS,28,017,"Chickasaw County, Mississippi",4493,1854,2639
21,MS,28,019,"Choctaw County, Mississippi",2147,862,1285
22,MS,28,021,"Claiborne County, Mississippi",3685,1830,1855
23,MS,28,023,"Clarke County, Mississippi",3460,1429,2031
24,MS,28,025,"Clay County, Mississippi",5302,2240,3062
25,MS,28,027,"Coahoma County, Mississippi",8420,3418,5002
26,MS,28,029,"Copiah County, Mississippi",7629,3440,4189
27,MS,28,031,"Covington County, Mississippi",5162,2139,3023
28,MS,28,033,"DeSoto County, Mississippi",16338,6777,9561
29,MS,28,035,"Forrest County, Mississippi",20179,9239,10940
30,MS,28,037,"Franklin County, Mississippi",1464,703,761
31,MS,28,039,"George County, Mississippi",4154,1784,2370
32,MS,28,041,"Greene County, Mississippi",1566,553,1013
33,MS,28,043,"Grenada County, Mississippi",4733,2254,2479
34,MS,28,045,"Hancock County, Mississippi",9807,4704,5103
35,MS,28,047,"Harrison County, Mississippi",39569,17498,22071
36,MS,28,049,"Hinds County, Mississippi",61498,26487,35011
37,MS,28,051,"Holmes County, Mississippi",7860,3472,4388
38,MS,28,053,"Humphreys County, Mississippi",3508,1539,1969
39,MS,28,055,"Issaquena County, Mississippi",411,234,177
40,MS,28,057,"Itawamba County, Mississippi",4207,2133,2074
41,MS,28,059,"Jackson County, Mississippi",21400,9488,11912
42,MS,28,061,"Jasper County, Mississippi",3944,1645,2299
43,MS,28,063,"Jefferson County, Mississippi",3490,1504,1986
44,MS,28,065,"Jefferson Davis County, Mississippi",4028,1624,2404
45,MS,28,067,"Jones County, Mississippi",15197,6073,9124
46,MS,28,069,"Kemper County, Mississippi",2841,1127,1714
47,MS,28,071,"Lafayette County, Mississippi",11903,5486,6417
48,MS,28,073,"Lamar County, Mississippi",9748,4503,5245
49,MS,28,075,"Lauderdale County, Mississippi",17325,6745,10580
50,MS,28,077,"Lawrence County, Mississippi",2769,1275,1494
51,MS,28,079,"Leake County, Mississippi",6034,2548,3486
52,MS,28,081,"Lee County, Mississippi",15327,6413,8914
53,MS,28,083,"Leflore County, Mississippi",12558,5473,7085
54,MS,28,085,"Lincoln County, Mississippi",9091,3751,5340
55,MS,28,087,"Lowndes County, Mississippi",13675,5540,8135
56,MS,28,089,"Madison County, Mississippi",13287,5430,7857
57,MS,28,091,"Marion County, Mississippi",7156,3313,3843
58,MS,28,093,"Marshall County, Mississippi",6513,2947,3566
59,MS,28,095,"Monroe County, Mississippi",7123,2940,4183
60,MS,28,097,"Montgomery County, Mississippi",3058,1215,1843
61,MS,28,099,"Neshoba County, Mississippi",6957,3071,3886
62,MS,28,101,"Newton County, Mississippi",4737,1955,2782
63,MS,28,103,"Noxubee County, Mississippi",3953,1771,2182
64,MS,28,105,"Oktibbeha County, Mississippi",14780,7021,7759
65,MS,28,107,"Panola County, Mississippi",7793,3400,4393
66,MS,28,109,"Pearl River County, Mississippi",11590,4999,6591
67,MS,28,111,"Perry County, Mississippi",2287,865,1422
68,MS,28,113,"Pike County, Mississippi",11334,4633,6701
69,MS,28,115,"Pontotoc County, Mississippi",4903,2537,2366
70,MS,28,117,"Prentiss County, Mississippi",5112,2431,2681
71,MS,28,119,"Quitman County, Mississippi",2982,1280,1702
72,MS,28,121,"Rankin County, Mississippi",14067,5528,8539
73,MS,28,123,"Scott County, Mississippi",7743,3362,4381
74,MS,28,125,"Sharkey County, Mississippi",1380,607,773
75,MS,28,127,"Simpson County, Mississippi",6985,3372,3613
76,MS,28,129,"Smith County, Mississippi",3813,1606,2207
77,MS,28,131,"Stone County, Mississippi",3103,1626,1477
78,MS,28,133,"Sunflower County, Mississippi",8458,3444,5014
79,MS,28,135,"Tallahatchie County, Mississippi",2609,881,1728
80,MS,28,137,"Tate County, Mississippi",4656,2196,2460
81,MS,28,139,"Tippah County, Mississippi",5311,2352,2959
82,MS,28,141,"Tishomingo County, Mississippi",3146,1342,1804
83,MS,28,143,"Tunica County, Mississippi",2824,999,1825
84,MS,28,145,"Union County, Mississippi",6170,2262,3908
85,MS,28,147,"Walthall County, Mississippi",4199,1956,2243
86,MS,28,149,"Warren County, Mississippi",10768,4265,6503
87,MS,28,151,"Washington County, Mississippi",17586,7493,10093
88,MS,28,153,"Wayne County, Mississippi",5509,2334,3175
89,MS,28,155,"Webster County, Mississippi",2243,977,1266
90,MS,28,157,"Wilkinson County, Mississippi",2687,1182,1505
91,MS,28,159,"Winston County, Mississippi",5389,2222,3167
92,MS,28,161,"Yalobusha County, Mississippi",2472,1069,1403
93,MS,28,163,"Yazoo County, Mississippi",8017,3652,4365
12,MT,30,001,"Beaverhead County, Montana",1446,604,842
13,MT,30,003,"Big Horn County, Montana",3788,1737,2051
14,MT,30,005,"Blaine County, Montana",1795,839,956
15,MT,30,007,"Broadwater County, Montana",556,257,299
16,MT,30,009,"Carbon County, Montana",1137,505,632
17,MT,30,011,"Carter County, Montana",141,42,99
18,MT,30,013,"Cascade County, Montana",12212,5336,6876
19,MT,30,015,"Chouteau County, Montana",1341,610,731
20,MT,30,017,"Custer County, Montana",1298,566,732
21,MT,30,019,"Daniels County, Montana",100,30,70
22,MT,30,021,"Dawson County, Montana",1210,741,469
23,MT,30,023,"Deer Lodge County, Montana",1499,739,760
24,MT,30,025,"Fallon County, Montana",198,60,138
25,MT,30,027,"Fergus County, Montana",1287,592,695
26,MT,30,029,"Flathead County, Montana",12307,5818,6489
27,MT,30,031,"Gallatin County, Montana",12125,6297,5828
28,MT,30,033,"Garfield County, Montana",96,54,42
29,MT,30,035,"Glacier County, Montana",4447,1962,2485
30,MT,30,037,"Golden Valley County, Montana",201,91,110
31,MT,30,039,"Granite County, Montana",466,218,248
32,MT,30,041,"Hill County, Montana",3400,1581,1819
33,MT,30,043,"Jefferson County, Montana",1068,531,537
34,MT,30,045,"Judith Basin County, Montana",281,141,140
35,MT,30,047,"Lake County, Montana",6509,3171,3338
36,MT,30,049,"Lewis and Clark County, Montana",7803,3651,4152
37,MT,30,051,"Liberty County, Montana",416,174,242
38,MT,30,053,"Lincoln County, Montana",3554,1627,1927
39,MT,30,055,"McCone County, Montana",151,78,73
40,MT,30,057,"Madison County, Montana",820,408,412
41,MT,30,059,"Meagher County, Montana",265,77,188
42,MT,30,061,"Mineral County, Montana",721,331,390
43,MT,30,063,"Missoula County, Montana",17414,8279,9135
44,MT,30,065,"Musselshell County, Montana",774,324,450
45,MT,30,067,"Park County, Montana",1918,828,1090
46,MT,30,069,"Petroleum County, Montana",30,12,18
47,MT,30,071,"Phillips County, Montana",651,274,377
48,MT,30,073,"Pondera County, Montana",1283,676,607
49,MT,30,075,"Powder River County, Montana",155,71,84
50,MT,30,077,"Powell County, Montana",735,319,416
51,MT,30,079,"Prairie County, Montana",239,113,126
52,MT,30,081,"Ravalli County, Montana",7308,3338,3970
53,MT,30,083,"Richland County, Montana",1264,547,717
54,MT,30,085,"Roosevelt County, Montana",3007,1383,1624
55,MT,30,087,"Rosebud County, Montana",1893,826,1067
56,MT,30,089,"Sanders County, Montana",2497,1104,1393
57,MT,30,091,"Sheridan County, Montana",373,165,208
58,MT,30,093,"Silver Bow County, Montana",6771,3228,3543
59,MT,30,095,"Stillwater County, Montana",721,312,409
60,MT,30,097,"Sweet Grass County, Montana",458,203,255
61,MT,30,099,"Teton County, Montana",723,348,375
62,MT,30,101,"Toole County, Montana",866,341,525
63,MT,30,103,"Treasure County, Montana",178,104,74
64,MT,30,105,"Valley County, Montana",885,432,453
65,MT,30,107,"Wheatland County, Montana",410,194,216
66,MT,30,109,"Wibaux County, Montana",145,54,91
67,MT,30,111,"Yellowstone County, Montana",17250,7477,9773
12,NC,37,001,"Alamance County, North Carolina",29042,13130,15912
13,NC,37,003,"Alexander County, North Carolina",6191,3003,3188
14,NC,37,005,"Alleghany County, North Carolina",1986,852,1134
15,NC,37,007,"Anson County, North Carolina",5865,2550,3315
16,NC,37,009,"Ashe County, North Carolina",5510,2737,2773
17,NC,37,011,"Avery County, North Carolina",2350,1240,1110
18,NC,37,013,"Beaufort County, North Carolina",8660,3746,4914
19,NC,37,015,"Bertie County, North Carolina",4304,2038,2266
20,NC,37,017,"Bladen County, North Carolina",9342,4175,5167
21,NC,37,019,"Brunswick County, North Carolina",18725,8143,10582
22,NC,37,021,"Buncombe County, North Carolina",38256,17640,20616
23,NC,37,023,"Burke County, North Carolina",17277,7762,9515
24,NC,37,025,"Cabarrus County, North Carolina",23384,10512,12872
25,NC,37,027,"Caldwell County, North Carolina",15765,6956,8809
26,NC,37,029,"Camden County, North Carolina",803,370,433
27,NC,37,031,"Carteret County, North Carolina",10056,4547,5509
28,NC,37,033,"Caswell County, North Carolina",4634,2029,2605
29,NC,37,035,"Catawba County, North Carolina",23629,10699,12930
30,NC,37,037,"Chatham County, North Carolina",9041,4550,4491
31,NC,37,039,"Cherokee County, North Carolina",5319,2403,2916
32,NC,37,041,"Chowan County, North Carolina",3832,1747,2085
33,NC,37,043,"Clay County, North Carolina",2235,1007,1228
34,NC,37,045,"Cleveland County, North Carolina",19156,8012,11144
35,NC,37,047,"Columbus County, North Carolina",12768,5572,7196
36,NC,37,049,"Craven County, North Carolina",15664,6578,9086
37,NC,37,051,"Cumberland County, North Carolina",54949,22453,32496
38,NC,37,053,"Currituck County, North Carolina",2497,1018,1479
39,NC,37,055,"Dare County, North Carolina",2885,1204,1681
40,NC,37,057,"Davidson County, North Carolina",25655,11254,14401
41,NC,37,059,"Davie County, North Carolina",5210,2384,2826
42,NC,37,061,"Duplin County, North Carolina",15606,7197,8409
43,NC,37,063,"Durham County, North Carolina",49835,23570,26265
44,NC,37,065,"Edgecombe County, North Carolina",14210,6021,8189
45,NC,37,067,"Forsyth County, North Carolina",69100,30558,38542
46,NC,37,069,"Franklin County, North Carolina",9603,4247,5356
47,NC,37,071,"Gaston County, North Carolina",36027,15570,20457
48,NC,37,073,"Gates County, North Carolina",1651,683,968
49,NC,37,075,"Graham County, North Carolina",1884,867,1017
50,NC,37,077,"Granville County, North Carolina",8943,4172,4771
51,NC,37,079,"Greene County, North Carolina",4962,2049,2913
52,NC,37,081,"Guilford County, North Carolina",86808,37328,49480
53,NC,37,083,"Halifax County, North Carolina",13660,6086,7574
54,NC,37,085,"Harnett County, North Carolina",22094,9986,12108
55,NC,37,087,"Haywood County, North Carolina",10056,4642,5414
56,NC,37,089,"Henderson County, North Carolina",14984,7217,7767
57,NC,37,091,"Hertford County, North Carolina",5475,2134,3341
58,NC,37,093,"Hoke County, North Carolina",11047,4612,6435
59,NC,37,095,"Hyde County, North Carolina",890,278,612
60,NC,37,097,"Iredell County, North Carolina",22803,9533,13270
61,NC,37,099,"Jackson County, North Carolina",8139,3911,4228
62,NC,37,101,"Johnston County, North Carolina",27086,12599,14487
63,NC,37,103,"Jones County, North Carolina",2173,889,1284
64,NC,37,105,"Lee County, North Carolina",10533,4363,6170
65,NC,37,107,"Lenoir County, North Carolina",13401,5724,7677
66,NC,37,109,"Lincoln County, North Carolina",12243,5509,6734
67,NC,37,111,"McDowell County, North Carolina",8897,4138,4759
68,NC,37,113,"Macon County, North Carolina",6401,2951,3450
69,NC,37,115,"Madison County, North Carolina",3616,1490,2126
70,NC,37,117,"Martin County, North Carolina",5007,2191,2816
71,NC,37,119,"Mecklenburg County, North Carolina",148326,65072,83254
72,NC,37,121,"Mitchell County, North Carolina",2910,1265,1645
73,NC,37,123,"Montgomery County, North Carolina",6716,2942,3774
74,NC,37,125,"Moore County, North Carolina",13808,5800,8008
75,NC,37,127,"Nash County, North Carolina",17141,7079,10062
76,NC,37,129,"New Hanover County, North Carolina",36717,15886,20831
77,NC,37,131,"Northampton County, North Carolina",5658,2269,3389
78,NC,37,133,"Onslow County, North Carolina",24916,10709,14207
79,NC,37,135,"Orange County, North Carolina",20236,8668,11568
80,NC,37,137,"Pamlico County, North Carolina",1674,715,959
81,NC,37,139,"Pasquotank County, North Carolina",7256,2976,4280
82,NC,37,141,"Pender County, North Carolina",9925,4191,5734
83,NC,37,143,"Perquimans County, North Carolina",2626,1160,1466
84,NC,37,145,"Person County, North Carolina",7708,3574,4134
85,NC,37,147,"Pitt County, North Carolina",42743,18057,24686
86,NC,37,149,"Polk County, North Carolina",2790,1322,1468
87,NC,37,151,"Randolph County, North Carolina",24770,11758,13012
88,NC,37,153,"Richmond County, North Carolina",11465,5045,6420
89,NC,37,155,"Robeson County, North Carolina",41538,18723,22815
90,NC,37,157,"Rockingham County, North Carolina",16968,7168,9800
91,NC,37,159,"Rowan County, North Carolina",24194,10656,13538
92,NC,37,161,"Rutherford County, North Carolina",13077,5970,7107
93,NC,37,163,"Sampson County, North Carolina",16050,7577,8473
94,NC,37,165,"Scotland County, North Carolina",10504,4613,5891
95,NC,37,167,"Stanly County, North Carolina",10356,4702,5654
96,NC,37,169,"Stokes County, North Carolina",7826,3615,4211
97,NC,37,171,"Surry County, North Carolina",14195,6484,7711
98,NC,37,173,"Swain County, North Carolina",3409,1553,1856
99,NC,37,175,"Transylvania County, North Carolina",4017,1819,2198
100,NC,37,177,"Tyrrell County, North Carolina",779,326,453
101,NC,37,179,"Union County, North Carolina",21416,10081,11335
102,NC,37,181,"Vance County, North Carolina",11064,4926,6138
103,NC,37,183,"Wake County, North Carolina",107687,49166,58521
104,NC,37,185,"Warren County, North Carolina",4692,2290,2402
105,NC,37,187,"Washington County, North Carolina",2737,841,1896
106,NC,37,189,"Watauga County, North Carolina",14726,7773,6953
107,NC,37,191,"Wayne County, North Carolina",27037,11517,15520
108,NC,37,193,"Wilkes County, North Carolina",15791,7521,8270
109,NC,37,195,"Wilson County, North Carolina",18475,8116,10359
110,NC,37,197,"Yadkin County, North Carolina",7643,3528,4115
111,NC,37,199,"Yancey County, North Carolina",3775,1653,2122
12,ND,38,001,"Adams County, North Dakota",220,90,130
13,ND,38,003,"Barnes County, North Dakota",841,396,445
14,ND,38,005,"Benson County, North Dakota",2260,1070,1190
15,ND,38,007,"Billings County, North Dakota",100,49,51
16,ND,38,009,"Bottineau County, North Dakota",540,188,352
17,ND,38,011,"Bowman County, North Dakota",234,80,154
18,ND,38,013,"Burke County, North Dakota",301,124,177
19,ND,38,015,"Burleigh County, North Dakota",6946,3052,3894
20,ND,38,017,"Cass County, North Dakota",19082,8990,10092
21,ND,38,019,"Cavalier County, North Dakota",180,43,137
22,ND,38,021,"Dickey County, North Dakota",400,151,249
23,ND,38,023,"Divide County, North Dakota",178,72,106
24,ND,38,025,"Dunn County, North Dakota",517,246,271
25,ND,38,027,"Eddy County, North Dakota",311,166,145
26,ND,38,029,"Emmons County, North Dakota",386,166,220
27,ND,38,031,"Foster County, North Dakota",316,107,209
28,ND,38,033,"Golden Valley County, North Dakota",177,68,109
29,ND,38,035,"Grand Forks County, North Dakota",11223,5076,6147
30,ND,38,037,"Grant County, North Dakota",346,143,203
31,ND,38,039,"Griggs County, North Dakota",179,78,101
32,ND,38,041,"Hettinger County, North Dakota",217,70,147
33,ND,38,043,"Kidder County, North Dakota",185,86,99
34,ND,38,045,"LaMoure County, North Dakota",383,152,231
35,ND,38,047,"Logan County, North Dakota",151,62,89
36,ND,38,049,"McHenry County, North Dakota",738,333,405
37,ND,38,051,"McIntosh County, North Dakota",311,80,231
38,ND,38,053,"McKenzie County, North Dakota",1309,670,639
39,ND,38,055,"McLean County, North Dakota",1072,441,631
40,ND,38,057,"Mercer County, North Dakota",693,217,476
41,ND,38,059,"Morton County, North Dakota",2270,1079,1191
42,ND,38,061,"Mountrail County, North Dakota",1226,608,618
43,ND,38,063,"Nelson County, North Dakota",249,105,144
44,ND,38,065,"Oliver County, North Dakota",137,66,71
45,ND,38,067,"Pembina County, North Dakota",454,193,261
46,ND,38,069,"Pierce County, North Dakota",693,307,386
47,ND,38,071,"Ramsey County, North Dakota",1118,565,553
48,ND,38,073,"Ransom County, North Dakota",490,191,299
49,ND,38,075,"Renville County, North Dakota",186,85,101
50,ND,38,077,"Richland County, North Dakota",1633,659,974
51,ND,38,079,"Rolette County, North Dakota",5054,2207,2847
52,ND,38,081,"Sargent County, North Dakota",222,80,142
53,ND,38,083,"Sheridan County, North Dakota",209,65,144
54,ND,38,085,"Sioux County, North Dakota",1524,717,807
55,ND,38,087,"Slope County, North Dakota",68,33,35
56,ND,38,089,"Stark County, North Dakota",1866,755,1111
57,ND,38,091,"Steele County, North Dakota",143,74,69
58,ND,38,093,"Stutsman County, North Dakota",2130,854,1276
59,ND,38,095,"Towner County, North Dakota",316,126,190
60,ND,38,097,"Traill County, North Dakota",804,436,368
61,ND,38,099,"Walsh County, North Dakota",1112,464,648
62,ND,38,101,"Ward County, North Dakota",4919,1861,3058
63,ND,38,103,"Wells County, North Dakota",226,110,116
64,ND,38,105,"Williams County, North Dakota",2913,1402,1511
12,NE,31,001,"Adams County, Nebraska",3499,1490,2009
13,NE,31,003,"Antelope County, Nebraska",811,353,458
14,NE,31,005,"Arthur County, Nebraska",36,19,17
15,NE,31,007,"Banner County, Nebraska",96,30,66
16,NE,31,009,"Blaine County, Nebraska",106,61,45
17,NE,31,011,"Boone County, Nebraska",533,208,325
18,NE,31,013,"Box Butte County, Nebraska",1886,758,1128
19,NE,31,015,"Boyd County, Nebraska",220,97,123
20,NE,31,017,"Brown County, Nebraska",499,241,258
21,NE,31,019,"Buffalo County, Nebraska",5978,2737,3241
22,NE,31,021,"Burt County, Nebraska",620,265,355
23,NE,31,023,"Butler County, Nebraska",682,309,373
24,NE,31,025,"Cass County, Nebraska",1556,739,817
25,NE,31,027,"Cedar County, Nebraska",864,385,479
26,NE,31,029,"Chase County, Nebraska",337,161,176
27,NE,31,031,"Cherry County, Nebraska",648,175,473
28,NE,31,033,"Cheyenne County, Nebraska",1150,420,730
29,NE,31,035,"Clay County, Nebraska",580,233,347
30,NE,31,037,"Colfax County, Nebraska",1374,675,699
31,NE,31,039,"Cuming County, Nebraska",1071,376,695
32,NE,31,041,"Custer County, Nebraska",1200,526,674
33,NE,31,043,"Dakota County, Nebraska",3528,1510,2018
34,NE,31,045,"Dawes County, Nebraska",1428,531,897
35,NE,31,047,"Dawson County, Nebraska",3618,1439,2179
36,NE,31,049,"Deuel County, Nebraska",246,90,156
37,NE,31,051,"Dixon County, Nebraska",683,309,374
38,NE,31,053,"Dodge County, Nebraska",4061,1819,2242
39,NE,31,055,"Douglas County, Nebraska",76738,33674,43064
40,NE,31,057,"Dundy County, Nebraska",151,69,82
41,NE,31,059,"Fillmore County, Nebraska",514,167,347
42,NE,31,061,"Franklin County, Nebraska",396,183,213
43,NE,31,063,"Frontier County, Nebraska",305,113,192
44,NE,31,065,"Furnas County, Nebraska",820,337,483
45,NE,31,067,"Gage County, Nebraska",2080,925,1155
46,NE,31,069,"Garden County, Nebraska",181,81,100
47,NE,31,071,"Garfield County, Nebraska",193,63,130
48,NE,31,073,"Gosper County, Nebraska",110,44,66
49,NE,31,075,"Grant County, Nebraska",98,47,51
50,NE,31,077,"Greeley County, Nebraska",243,97,146
51,NE,31,079,"Hall County, Nebraska",9092,3927,5165
52,NE,31,081,"Hamilton County, Nebraska",780,303,477
53,NE,31,083,"Harlan County, Nebraska",450,215,235
54,NE,31,085,"Hayes County, Nebraska",68,36,32
55,NE,31,087,"Hitchcock County, Nebraska",490,237,253
56,NE,31,089,"Holt County, Nebraska",1209,512,697
57,NE,31,091,"Hooker County, Nebraska",123,71,52
58,NE,31,093,"Howard County, Nebraska",658,333,325
59,NE,31,095,"Jefferson County, Nebraska",909,361,548
60,NE,31,097,"Johnson County, Nebraska",471,214,257
61,NE,31,099,"Kearney County, Nebraska",408,181,227
62,NE,31,101,"Keith County, Nebraska",931,393,538
63,NE,31,103,"Keya Paha County, Nebraska",106,41,65
64,NE,31,105,"Kimball County, Nebraska",496,205,291
65,NE,31,107,"Knox County, Nebraska",1117,426,691
66,NE,31,109,"Lancaster County, Nebraska",41796,18624,23172
67,NE,31,111,"Lincoln County, Nebraska",4488,1775,2713
68,NE,31,113,"Logan County, Nebraska",91,33,58
69,NE,31,115,"Loup County, Nebraska",68,30,38
70,NE,31,117,"McPherson County, Nebraska",64,32,32
71,NE,31,119,"Madison County, Nebraska",5119,2075,3044
72,NE,31,121,"Merrick County, Nebraska",667,344,323
73,NE,31,123,"Morrill County, Nebraska",550,259,291
74,NE,31,125,"Nance County, Nebraska",490,253,237
75,NE,31,127,"Nemaha County, Nebraska",574,300,274
76,NE,31,129,"Nuckolls County, Nebraska",501,182,319
77,NE,31,131,"Otoe County, Nebraska",1696,740,956
78,NE,31,133,"Pawnee County, Nebraska",446,207,239
79,NE,31,135,"Perkins County, Nebraska",198,46,152
80,NE,31,137,"Phelps County, Nebraska",706,213,493
81,NE,31,139,"Pierce County, Nebraska",417,174,243
82,NE,31,141,"Platte County, Nebraska",2728,1336,1392
83,NE,31,143,"Polk County, Nebraska",389,184,205
84,NE,31,145,"Red Willow County, Nebraska",1118,572,546
85,NE,31,147,"Richardson County, Nebraska",1557,690,867
86,NE,31,149,"Rock County, Nebraska",162,48,114
87,NE,31,151,"Saline County, Nebraska",1492,705,787
88,NE,31,153,"Sarpy County, Nebraska",10684,4831,5853
89,NE,31,155,"Saunders County, Nebraska",2001,911,1090
90,NE,31,157,"Scotts Bluff County, Nebraska",4877,2163,2714
91,NE,31,159,"Seward County, Nebraska",1467,738,729
92,NE,31,161,"Sheridan County, Nebraska",857,426,431
93,NE,31,163,"Sherman County, Nebraska",411,126,285
94,NE,31,165,"Sioux County, Nebraska",156,64,92
95,NE,31,167,"Stanton County, Nebraska",701,298,403
96,NE,31,169,"Thayer County, Nebraska",604,298,306
97,NE,31,171,"Thomas County, Nebraska",55,24,31
98,NE,31,173,"Thurston County, Nebraska",2090,947,1143
99,NE,31,175,"Valley County, Nebraska",540,251,289
100,NE,31,177,"Washington County, Nebraska",1880,595,1285
101,NE,31,179,"Wayne County, Nebraska",1115,644,471
102,NE,31,181,"Webster County, Nebraska",459,235,224
103,NE,31,183,"Wheeler County, Nebraska",61,30,31
104,NE,31,185,"York County, Nebraska",1393,621,772
12,NH,33,001,"Belknap County, New Hampshire",6214,2893,3321
13,NH,33,003,"Carroll County, New Hampshire",4484,2015,2469
14,NH,33,005,"Cheshire County, New Hampshire",8467,3684,4783
15,NH,33,007,"Coos County, New Hampshire",4257,1950,2307
16,NH,33,009,"Grafton County, New Hampshire",9609,4252,5357
17,NH,33,011,"Hillsborough County, New Hampshire",34681,15707,18974
18,NH,33,013,"Merrimack County, New Hampshire",12840,5578,7262
19,NH,33,015,"Rockingham County, New Hampshire",16192,7315,8877
20,NH,33,017,"Strafford County, New Hampshire",12997,5717,7280
21,NH,33,019,"Sullivan County, New Hampshire",4099,1959,2140
7,NJ,34,001,"Atlantic County, New Jersey",40868,18753,22115
8,NJ,34,003,"Bergen County, New Jersey",67959,29262,38697
9,NJ,34,005,"Burlington County, New Jersey",27881,12238,15643
10,NJ,34,007,"Camden County, New Jersey",66802,28813,37989
11,NJ,34,009,"Cape May County, New Jersey",9744,4179,5565
12,NJ,34,011,"Cumberland County, New Jersey",25760,11633,14127
13,NJ,34,013,"Essex County, New Jersey",133788,57543,76245
14,NJ,34,015,"Gloucester County, New Jersey",23200,9915,13285
15,NJ,34,017,"Hudson County, New Jersey",114900,50273,64627
16,NJ,34,019,"Hunterdon County, New Jersey",5379,2236,3143
17,NJ,34,021,"Mercer County, New Jersey",40354,18218,22136
18,NJ,34,023,"Middlesex County, New Jersey",70908,31792,39116
19,NJ,34,025,"Monmouth County, New Jersey",46492,20092,26400
20,NJ,34,027,"Morris County, New Jersey",22068,9710,12358
21,NJ,34,029,"Ocean County, New Jersey",64795,29231,35564
22,NJ,34,031,"Passaic County, New Jersey",83203,37009,46194
23,NJ,34,033,"Salem County, New Jersey",8602,3826,4776
24,NJ,34,035,"Somerset County, New Jersey",16479,7340,9139
25,NJ,34,037,"Sussex County, New Jersey",8237,3862,4375
26,NJ,34,039,"Union County, New Jersey",59034,24322,34712
27,NJ,34,041,"Warren County, New Jersey",8394,3681,4713
12,NM,35,001,"Bernalillo County, New Mexico",128917,59967,68950
13,NM,35,003,"Catron County, New Mexico",615,177,438
14,NM,35,005,"Chaves County, New Mexico",14013,6312,7701
15,NM,35,006,"Cibola County, New Mexico",7489,3567,3922
16,NM,35,007,"Colfax County, New Mexico",2490,1121,1369
17,NM,35,009,"Curry County, New Mexico",10338,4527,5811
18,NM,35,011,"De Baca County, New Mexico",454,227,227
19,NM,35,013,"Doña Ana County, New Mexico",58846,27487,31359
20,NM,35,015,"Eddy County, New Mexico",6237,2460,3777
21,NM,35,017,"Grant County, New Mexico",5940,2771,3169
22,NM,35,019,"Guadalupe County, New Mexico",552,239,313
23,NM,35,021,"Harding County, New Mexico",59,29,30
24,NM,35,023,"Hidalgo County, New Mexico",1054,443,611
25,NM,35,025,"Lea County, New Mexico",9859,3934,5925
26,NM,35,027,"Lincoln County, New Mexico",3271,1479,1792
27,NM,35,028,"Los Alamos County, New Mexico",1092,429,663
28,NM,35,029,"Luna County, New Mexico",7236,3080,4156
29,NM,35,031,"McKinley County, New Mexico",27493,13235,14258
30,NM,35,033,"Mora County, New Mexico",1092,669,423
31,NM,35,035,"Otero County, New Mexico",14387,6638,7749
32,NM,35,037,"Quay County, New Mexico",1484,640,844
33,NM,35,039,"Rio Arriba County, New Mexico",9413,4770,4643
34,NM,35,041,"Roosevelt County, New Mexico",4918,2164,2754
35,NM,35,043,"Sandoval County, New Mexico",19305,8939,10366
36,NM,35,045,"San Juan County, New Mexico",24755,11972,12783
37,NM,35,047,"San Miguel County, New Mexico",8093,3544,4549
38,NM,35,049,"Santa Fe County, New Mexico",22477,10373,12104
39,NM,35,051,"Sierra County, New Mexico",2360,1347,1013
40,NM,35,053,"Socorro County, New Mexico",4278,1928,2350
41,NM,35,055,"Taos County, New Mexico",7909,3785,4124
42,NM,35,057,"Torrance County, New Mexico",4833,2325,2508
43,NM,35,059,"Union County, New Mexico",498,176,322
44,NM,35,061,"Valencia County, New Mexico",17604,8399,9205
12,NV,32,001,"Churchill County, Nevada",3802,1765,2037
13,NV,32,003,"Clark County, Nevada",315358,147575,167783
14,NV,32,005,"Douglas County, Nevada",4984,2264,2720
15,NV,32,007,"Elko County, Nevada",5574,2675,2899
16,NV,32,009,"Esmeralda County, Nevada",194,53,141
17,NV,32,011,"Eureka County, Nevada",162,106,56
18,NV,32,013,"Humboldt County, Nevada",1762,802,960
19,NV,32,015,"Lander County, Nevada",676,349,327
20,NV,32,017,"Lincoln County, Nevada",631,372,259
21,NV,32,019,"Lyon County, Nevada",8482,3749,4733
22,NV,32,021,"Mineral County, Nevada",907,429,478
23,NV,32,023,"Nye County, Nevada",7658,3541,4117
24,NV,32,027,"Pershing County, Nevada",832,350,482
25,NV,32,029,"Storey County, Nevada",293,134,159
26,NV,32,031,"Washoe County, Nevada",65248,30454,34794
27,NV,32,033,"White Pine County, Nevada",987,381,606
28,NV,32,510,"Carson City, Nevada",8787,3992,4795
12,NY,36,001,"Albany County, New York",39349,17368,21981
13,NY,36,003,"Allegany County, New York",7285,3424,3861
14,NY,36,005,"Bronx County, New York",427574,181112,246462
15,NY,36,007,"Broome County, New York",33615,15839,17776
16,NY,36,009,"Cattaraugus County, New York",13954,6444,7510
17,NY,36,011,"Cayuga County, New York",9010,4089,4921
18,NY,36,013,"Chautauqua County, New York",23894,10816,13078
19,NY,36,015,"Chemung County, New York",13044,5401,7643
20,NY,36,017,"Chenango County, New York",7741,3403,4338
21,NY,36,019,"Clinton County, New York",12163,5245,6918
22,NY,36,021,"Columbia County, New York",7067,3251,3816
23,NY,36,023,"Cortland County, New York",6675,2638,4037
24,NY,36,025,"Delaware County, New York",6799,3306,3493
25,NY,36,027,"Dutchess County, New York",26229,11831,14398
26,NY,36,029,"Erie County, New York",134715,59086,75629
27,NY,36,031,"Essex County, New York",3894,1756,2138
28,NY,36,033,"Franklin County, New York",9213,4383,4830
29,NY,36,035,"Fulton County, New York",9100,4176,4924
30,NY,36,037,"Genesee County, New York",7748,3521,4227
31,NY,36,039,"Greene County, New York",5813,2342,3471
32,NY,36,041,"Hamilton County, New York",609,317,292
33,NY,36,043,"Herkimer County, New York",9145,4089,5056
34,NY,36,045,"Jefferson County, New York",16938,7850,9088
35,NY,36,047,"Kings County, New York",597404,265335,332069
36,NY,36,049,"Lewis County, New York",3238,1478,1760
37,NY,36,051,"Livingston County, New York",8681,3775,4906
38,NY,36,053,"Madison County, New York",8180,3640,4540
39,NY,36,055,"Monroe County, New York",110192,48774,61418
40,NY,36,057,"Montgomery County, New York",10053,4433,5620
41,NY,36,059,"Nassau County, New York",82146,35207,46939
42,NY,36,061,"New York County, New York",283590,123922,159668
43,NY,36,063,"Niagara County, New York",28816,12569,16247
44,NY,36,065,"Oneida County, New York",37760,17386,20374
45,NY,36,067,"Onondaga County, New York",69487,31279,38208
46,NY,36,069,"Ontario County, New York",10975,4935,6040
47,NY,36,071,"Orange County, New York",46731,21428,25303
48,NY,36,073,"Orleans County, New York",6173,2836,3337
49,NY,36,075,"Oswego County, New York",21615,10192,11423
50,NY,36,077,"Otsego County, New York",9275,4372,4903
51,NY,36,079,"Putnam County, New York",5212,2693,2519
52,NY,36,081,"Queens County, New York",343834,148985,194849
53,NY,36,083,"Rensselaer County, New York",19186,8695,10491
54,NY,36,085,"Richmond County, New York",58470,26399,32071
55,NY,36,087,"Rockland County, New York",46118,21825,24293
56,NY,36,089,"St. Lawrence County, New York",19494,9391,10103
57,NY,36,091,"Saratoga County, New York",14583,6435,8148
58,NY,36,093,"Schenectady County, New York",19028,8584,10444
59,NY,36,095,"Schoharie County, New York",3936,1911,2025
60,NY,36,097,"Schuyler County, New York",2595,1062,1533
61,NY,36,099,"Seneca County, New York",4081,1817,2264
62,NY,36,101,"Steuben County, New York",15888,7157,8731
63,NY,36,103,"Suffolk County, New York",103269,45309,57960
64,NY,36,105,"Sullivan County, New York",12868,6015,6853
65,NY,36,107,"Tioga County, New York",4801,2062,2739
66,NY,36,109,"Tompkins County, New York",18547,8362,10185
67,NY,36,111,"Ulster County, New York",22290,10453,11837
68,NY,36,113,"Warren County, New York",7685,3218,4467
69,NY,36,115,"Washington County, New York",8004,3581,4423
70,NY,36,117,"Wayne County, New York",11541,5486,6055
71,NY,36,119,"Westchester County, New York",90752,39737,51015
72,NY,36,121,"Wyoming County, New York",4425,2081,2344
73,NY,36,123,"Yates County, New York",3446,1583,1863
12,OH,39,001,"Adams County, Ohio",6832,2970,3862
13,OH,39,003,"Allen County, Ohio",17713,8327,9386
14,OH,39,005,"Ashland County, Ohio",7569,3496,4073
15,OH,39,007,"Ashtabula County, Ohio",19266,8329,10937
16,OH,39,009,"Athens County, Ohio",18263,9227,9036
17,OH,39,011,"Auglaize County, Ohio",4010,1627,2383
18,OH,39,013,"Belmont County, Ohio",9553,4021,5532
19,OH,39,015,"Brown County, Ohio",6442,2678,3764
20,OH,39,017,"Butler County, Ohio",50312,21472,28840
21,OH,39,019,"Carroll County, Ohio",4317,1997,2320
22,OH,39,021,"Champaign County, Ohio",4756,2217,2539
23,OH,39,023,"Clark County, Ohio",24419,10932,13487
24,OH,39,025,"Clermont County, Ohio",21127,9318,11809
25,OH,39,027,"Clinton County, Ohio",6425,3000,3425
26,OH,39,029,"Columbiana County, Ohio",15730,6792,8938
27,OH,39,031,"Coshocton County, Ohio",5835,2516,3319
28,OH,39,033,"Crawford County, Ohio",6888,2976,3912
29,OH,39,035,"Cuyahoga County, Ohio",231823,101682,130141
30,OH,39,037,"Darke County, Ohio",6846,3045,3801
31,OH,39,039,"Defiance County, Ohio",5071,2187,2884
32,OH,39,041,"Delaware County, Ohio",8285,3705,4580
33,OH,39,043,"Erie County, Ohio",9333,4116,5217
34,OH,39,045,"Fairfield County, Ohio",15110,6752,8358
35,OH,39,047,"Fayette County, Ohio",5185,2461,2724
36,OH,39,049,"Franklin County, Ohio",208422,95908,112514
37,OH,39,051,"Fulton County, Ohio",4532,2197,2335
38,OH,39,053,"Gallia County, Ohio",6214,2541,3673
39,OH,39,055,"Geauga County, Ohio",6969,3258,3711
40,OH,39,057,"Greene County, Ohio",21065,9574,11491
41,OH,39,059,"Guernsey County, Ohio",7784,3427,4357
42,OH,39,061,"Hamilton County, Ohio",143778,63809,79969
43,OH,39,063,"Hancock County, Ohio",10221,4369,5852
44,OH,39,065,"Hardin County, Ohio",5491,2667,2824
45,OH,39,067,"Harrison County, Ohio",2657,1186,1471
46,OH,39,069,"Henry County, Ohio",3144,1325,1819
47,OH,39,071,"Highland County, Ohio",8604,3780,4824
48,OH,39,073,"Hocking County, Ohio",4894,2116,2778
49,OH,39,075,"Holmes County, Ohio",5398,2451,2947
50,OH,39,077,"Huron County, Ohio",7853,3501,4352
51,OH,39,079,"Jackson County, Ohio",7637,3320,4317
52,OH,39,081,"Jefferson County, Ohio",11533,4875,6658
53,OH,39,083,"Knox County, Ohio",8825,3995,4830
54,OH,39,085,"Lake County, Ohio",20063,8926,11137
55,OH,39,087,"Lawrence County, Ohio",11135,5080,6055
56,OH,39,089,"Licking County, Ohio",20926,9134,11792
57,OH,39,091,"Logan County, Ohio",6487,2767,3720
58,OH,39,093,"Lorain County, Ohio",42269,17426,24843
59,OH,39,095,"Lucas County, Ohio",90091,42034,48057
60,OH,39,097,"Madison County, Ohio",3580,1621,1959
61,OH,39,099,"Mahoning County, Ohio",40841,17922,22919
62,OH,39,101,"Marion County, Ohio",11127,4978,6149
63,OH,39,103,"Medina County, Ohio",12859,5798,7061
64,OH,39,105,"Meigs County, Ohio",5285,2498,2787
65,OH,39,107,"Mercer County, Ohio",3399,1428,1971
66,OH,39,109,"Miami County, Ohio",13076,5466,7610
67,OH,39,111,"Monroe County, Ohio",2782,1268,1514
68,OH,39,113,"Montgomery County, Ohio",96354,42909,53445
69,OH,39,115,"Morgan County, Ohio",3111,1481,1630
70,OH,39,117,"Morrow County, Ohio",4063,2119,1944
71,OH,39,119,"Muskingum County, Ohio",15554,7155,8399
72,OH,39,121,"Noble County, Ohio",1521,670,851
73,OH,39,123,"Ottawa County, Ohio",4349,1803,2546
74,OH,39,125,"Paulding County, Ohio",2436,1188,1248
75,OH,39,127,"Perry County, Ohio",6876,2994,3882
76,OH,39,129,"Pickaway County, Ohio",6509,3040,3469
77,OH,39,131,"Pike County, Ohio",6436,3038,3398
78,OH,39,133,"Portage County, Ohio",24219,10238,13981
79,OH,39,135,"Preble County, Ohio",5477,2504,2973
80,OH,39,137,"Putnam County, Ohio",1966,831,1135
81,OH,39,139,"Richland County, Ohio",19504,8622,10882
82,OH,39,141,"Ross County, Ohio",13746,6062,7684
83,OH,39,143,"Sandusky County, Ohio",8458,3644,4814
84,OH,39,145,"Scioto County, Ohio",18740,8702,10038
85,OH,39,147,"Seneca County, Ohio",8923,4164,4759
86,OH,39,149,"Shelby County, Ohio",4970,2048,2922
87,OH,39,151,"Stark County, Ohio",53715,23898,29817
88,OH,39,153,"Summit County, Ohio",78658,35036,43622
89,OH,39,155,"Trumbull County, Ohio",34912,15220,19692
90,OH,39,157,"Tuscarawas County, Ohio",12763,5748,7015
91,OH,39,159,"Union County, Ohio",4344,1959,2385
92,OH,39,161,"Van Wert County, Ohio",3600,1623,1977
93,OH,39,163,"Vinton County, Ohio",2713,1100,1613
94,OH,39,165,"Warren County, Ohio",11885,4930,6955
95,OH,39,167,"Washington County, Ohio",9777,4438,5339
96,OH,39,169,"Wayne County, Ohio",14758,6498,8260
97,OH,39,171,"Williams County, Ohio",5386,2265,3121
98,OH,39,173,"Wood County, Ohio",17461,8079,9382
99,OH,39,175,"Wyandot County, Ohio",2601,1060,1541
12,OK,40,001,"Adair County, Oklahoma",5897,2813,3084
13,OK,40,003,"Alfalfa County, Oklahoma",606,319,287
14,OK,40,005,"Atoka County, Oklahoma",2794,1204,1590
15,OK,40,007,"Beaver County, Oklahoma",492,182,310
16,OK,40,009,"Beckham County, Oklahoma",2777,1101,1676
17,OK,40,011,"Blaine County, Oklahoma",1293,524,769
18,OK,40,013,"Bryan County, Oklahoma",7816,3424,4392
19,OK,40,015,"Caddo County, Oklahoma",5976,2901,3075
20,OK,40,017,"Canadian County, Oklahoma",8995,3890,5105
21,OK,40,019,"Carter County, Oklahoma",7262,3135,4127
22,OK,40,021,"Cherokee County, Oklahoma",10426,5020,5406
23,OK,40,023,"Choctaw County, Oklahoma",4297,1952,2345
24,OK,40,025,"Cimarron County, Oklahoma",414,174,240
25,OK,40,027,"Cleveland County, Oklahoma",32758,15142,17616
26,OK,40,029,"Coal County, Oklahoma",1186,515,671
27,OK,40,031,"Comanche County, Oklahoma",20444,8810,11634
28,OK,40,033,"Cotton County, Oklahoma",1030,467,563
29,OK,40,035,"Craig County, Oklahoma",2659,1162,1497
30,OK,40,037,"Creek County, Oklahoma",10813,4877,5936
31,OK,40,039,"Custer County, Oklahoma",4595,2089,2506
32,OK,40,041,"Delaware County, Oklahoma",8311,3830,4481
33,OK,40,043,"Dewey County, Oklahoma",788,367,421
34,OK,40,045,"Ellis County, Oklahoma",595,291,304
35,OK,40,047,"Garfield County, Oklahoma",7852,3563,4289
36,OK,40,049,"Garvin County, Oklahoma",5038,2280,2758
37,OK,40,051,"Grady County, Oklahoma",6690,2780,3910
38,OK,40,053,"Grant County, Oklahoma",430,156,274
39,OK,40,055,"Greer County, Oklahoma",735,346,389
40,OK,40,057,"Harmon County, Oklahoma",481,172,309
41,OK,40,059,"Harper County, Oklahoma",520,272,248
42,OK,40,061,"Haskell County, Oklahoma",2524,1126,1398
43,OK,40,063,"Hughes County, Oklahoma",2244,1025,1219
44,OK,40,065,"Jackson County, Oklahoma",4276,1665,2611
45,OK,40,067,"Jefferson County, Oklahoma",1313,607,706
46,OK,40,069,"Johnston County, Oklahoma",2070,777,1293
47,OK,40,071,"Kay County, Oklahoma",8137,3467,4670
48,OK,40,073,"Kingfisher County, Oklahoma",1093,481,612
49,OK,40,075,"Kiowa County, Oklahoma",1883,806,1077
50,OK,40,077,"Latimer County, Oklahoma",1833,776,1057
51,OK,40,079,"Le Flore County, Oklahoma",11035,4903,6132
52,OK,40,081,"Lincoln County, Oklahoma",5335,2418,2917
53,OK,40,083,"Logan County, Oklahoma",4943,2388,2555
54,OK,40,085,"Love County, Oklahoma",1292,604,688
55,OK,40,087,"McClain County, Oklahoma",3944,1922,2022
56,OK,40,089,"McCurtain County, Oklahoma",8256,3703,4553
57,OK,40,091,"McIntosh County, Oklahoma",4209,1975,2234
58,OK,40,093,"Major County, Oklahoma",1073,456,617
59,OK,40,095,"Marshall County, Oklahoma",2645,1134,1511
60,OK,40,097,"Mayes County, Oklahoma",8585,3814,4771
61,OK,40,099,"Murray County, Oklahoma",2012,764,1248
62,OK,40,101,"Muskogee County, Oklahoma",14670,6326,8344
63,OK,40,103,"Noble County, Oklahoma",1515,695,820
64,OK,40,105,"Nowata County, Oklahoma",1928,881,1047
65,OK,40,107,"Okfuskee County, Oklahoma",2797,1344,1453
66,OK,40,109,"Oklahoma County, Oklahoma",134377,59501,74876
67,OK,40,111,"Okmulgee County, Oklahoma",7880,3555,4325
68,OK,40,113,"Osage County, Oklahoma",7365,3002,4363
69,OK,40,115,"Ottawa County, Oklahoma",7112,3361,3751
70,OK,40,117,"Pawnee County, Oklahoma",2249,980,1269
71,OK,40,119,"Payne County, Oklahoma",18483,9075,9408
72,OK,40,121,"Pittsburg County, Oklahoma",7994,3657,4337
73,OK,40,123,"Pontotoc County, Oklahoma",6769,3222,3547
74,OK,40,125,"Pottawatomie County, Oklahoma",12288,5580,6708
75,OK,40,127,"Pushmataha County, Oklahoma",2716,1195,1521
76,OK,40,129,"Roger Mills County, Oklahoma",544,246,298
77,OK,40,131,"Rogers County, Oklahoma",8271,3365,4906
78,OK,40,133,"Seminole County, Oklahoma",5371,2334,3037
79,OK,40,135,"Sequoyah County, Oklahoma",10261,5048,5213
80,OK,40,137,"Stephens County, Oklahoma",6740,2876,3864
81,OK,40,139,"Texas County, Oklahoma",2733,1158,1575
82,OK,40,141,"Tillman County, Oklahoma",1750,848,902
83,OK,40,143,"Tulsa County, Oklahoma",96498,42178,54320
84,OK,40,145,"Wagoner County, Oklahoma",8150,3605,4545
85,OK,40,147,"Washington County, Oklahoma",7307,3205,4102
86,OK,40,149,"Washita County, Oklahoma",1725,666,1059
87,OK,40,151,"Woods County, Oklahoma",1283,662,621
88,OK,40,153,"Woodward County, Oklahoma",2595,1056,1539
12,OR,41,001,"Baker County, Oregon",2353,1144,1209
13,OR,41,003,"Benton County, Oregon",18139,9502,8637
14,OR,41,005,"Clackamas County, Oregon",36894,16509,20385
15,OR,41,007,"Clatsop County, Oregon",5791,2590,3201
16,OR,41,009,"Columbia County, Oregon",6638,3004,3634
17,OR,41,011,"Coos County, Oregon",11310,5154,6156
18,OR,41,013,"Crook County, Oregon",4048,1787,2261
19,OR,41,015,"Curry County, Oregon",3682,1519,2163
20,OR,41,017,"Deschutes County, Oregon",24220,11509,12711
21,OR,41,019,"Douglas County, Oregon",20377,8874,11503
22,OR,41,021,"Gilliam County, Oregon",186,81,105
23,OR,41,023,"Grant County, Oregon",1138,508,630
24,OR,41,025,"Harney County, Oregon",1268,573,695
25,OR,41,027,"Hood River County, Oregon",3223,1435,1788
26,OR,41,029,"Jackson County, Oregon",39122,18447,20675
27,OR,41,031,"Jefferson County, Oregon",4358,2092,2266
28,OR,41,033,"Josephine County, Oregon",16627,8447,8180
29,OR,41,035,"Klamath County, Oregon",12542,5452,7090
30,OR,41,037,"Lake County, Oregon",1365,663,702
31,OR,41,039,"Lane County, Oregon",70308,34709,35599
32,OR,41,041,"Lincoln County, Oregon",7754,3580,4174
33,OR,41,043,"Linn County, Oregon",22201,9995,12206
34,OR,41,045,"Malheur County, Oregon",6865,2879,3986
35,OR,41,047,"Marion County, Oregon",57846,26573,31273
36,OR,41,049,"Morrow County, Oregon",1844,862,982
37,OR,41,051,"Multnomah County, Oregon",136472,64213,72259
38,OR,41,053,"Polk County, Oregon",12270,5616,6654
39,OR,41,055,"Sherman County, Oregon",386,170,216
40,OR,41,057,"Tillamook County, Oregon",4310,2086,2224
41,OR,41,059,"Umatilla County, Oregon",12733,5516,7217
42,OR,41,061,"Union County, Oregon",4641,1955,2686
43,OR,41,063,"Wallowa County, Oregon",1033,492,541
44,OR,41,065,"Wasco County, Oregon",4015,1812,2203
45,OR,41,067,"Washington County, Oregon",64861,29554,35307
46,OR,41,069,"Wheeler County, Oregon",250,107,143
47,OR,41,071,"Yamhill County, Oregon",15877,7131,8746
12,PA,42,001,"Adams County, Pennsylvania",8715,3721,4994
13,PA,42,003,"Allegheny County, Pennsylvania",155874,67353,88521
14,PA,42,005,"Armstrong County, Pennsylvania",8738,3962,4776
15,PA,42,007,"Beaver County, Pennsylvania",19888,8582,11306
16,PA,42,009,"Bedford County, Pennsylvania",6643,2986,3657
17,PA,42,011,"Berks County, Pennsylvania",56855,25575,31280
18,PA,42,013,"Blair County, Pennsylvania",18548,8198,10350
19,PA,42,015,"Bradford County, Pennsylvania",8336,3681,4655
20,PA,42,017,"Bucks County, Pennsylvania",36868,15318,21550
21,PA,42,019,"Butler County, Pennsylvania",16325,7113,9212
22,PA,42,021,"Cambria County, Pennsylvania",20011,8513,11498
23,PA,42,023,"Cameron County, Pennsylvania",626,217,409
24,PA,42,025,"Carbon County, Pennsylvania",6909,2993,3916
25,PA,42,027,"Centre County, Pennsylvania",27217,14043,13174
26,PA,42,029,"Chester County, Pennsylvania",35053,15855,19198
27,PA,42,031,"Clarion County, Pennsylvania",6881,3045,3836
28,PA,42,033,"Clearfield County, Pennsylvania",11306,5035,6271
29,PA,42,035,"Clinton County, Pennsylvania",6086,2474,3612
30,PA,42,037,"Columbia County, Pennsylvania",10067,4475,5592
31,PA,42,039,"Crawford County, Pennsylvania",12321,5698,6623
32,PA,42,041,"Cumberland County, Pennsylvania",19984,8850,11134
33,PA,42,043,"Dauphin County, Pennsylvania",36269,16243,20026
34,PA,42,045,"Delaware County, Pennsylvania",57202,25013,32189
35,PA,42,047,"Elk County, Pennsylvania",2721,1090,1631
36,PA,42,049,"Erie County, Pennsylvania",44595,19834,24761
37,PA,42,051,"Fayette County, Pennsylvania",25282,10838,14444
38,PA,42,053,"Forest County, Pennsylvania",523,245,278
39,PA,42,055,"Franklin County, Pennsylvania",17554,7644,9910
40,PA,42,057,"Fulton County, Pennsylvania",1779,763,1016
41,PA,42,059,"Greene County, Pennsylvania",4672,1970,2702
42,PA,42,061,"Huntingdon County, Pennsylvania",5578,2342,3236
43,PA,42,063,"Indiana County, Pennsylvania",14176,6724,7452
44,PA,42,065,"Jefferson County, Pennsylvania",6414,2841,3573
45,PA,42,067,"Juniata County, Pennsylvania",3245,1410,1835
46,PA,42,069,"Lackawanna County, Pennsylvania",30447,13104,17343
47,PA,42,071,"Lancaster County, Pennsylvania",55372,25250,30122
48,PA,42,073,"Lawrence County, Pennsylvania",13192,5770,7422
49,PA,42,075,"Lebanon County, Pennsylvania",14922,6555,8367
50,PA,42,077,"Lehigh County, Pennsylvania",45488,19230,26258
51,PA,42,079,"Luzerne County, Pennsylvania",48822,21579,27243
52,PA,42,081,"Lycoming County, Pennsylvania",16150,7164,8986
53,PA,42,083,"McKean County, Pennsylvania",6830,3230,3600
54,PA,42,085,"Mercer County, Pennsylvania",14549,6345,8204
55,PA,42,087,"Mifflin County, Pennsylvania",7216,3249,3967
56,PA,42,089,"Monroe County, Pennsylvania",20702,9712,10990
57,PA,42,091,"Montgomery County, Pennsylvania",52330,22642,29688
58,PA,42,093,"Montour County, Pennsylvania",1749,722,1027
59,PA,42,095,"Northampton County, Pennsylvania",27294,11982,15312
60,PA,42,097,"Northumberland County, Pennsylvania",12279,5998,6281
61,PA,42,099,"Perry County, Pennsylvania",4217,1783,2434
62,PA,42,101,"Philadelphia County, Pennsylvania",399352,178789,220563
63,PA,42,103,"Pike County, Pennsylvania",5532,2403,3129
64,PA,42,105,"Potter County, Pennsylvania",2570,1124,1446
65,PA,42,107,"Schuylkill County, Pennsylvania",18278,8099,10179
66,PA,42,109,"Snyder County, Pennsylvania",4077,1683,2394
67,PA,42,111,"Somerset County, Pennsylvania",9074,3689,5385
68,PA,42,113,"Sullivan County, Pennsylvania",802,459,343
69,PA,42,115,"Susquehanna County, Pennsylvania",5455,2517,2938
70,PA,42,117,"Tioga County, Pennsylvania",5891,2553,3338
71,PA,42,119,"Union County, Pennsylvania",4554,1984,2570
72,PA,42,121,"Venango County, Pennsylvania",8123,3615,4508
73,PA,42,123,"Warren County, Pennsylvania",4891,2209,2682
74,PA,42,125,"Washington County, Pennsylvania",21074,9161,11913
75,PA,42,127,"Wayne County, Pennsylvania",6164,2836,3328
76,PA,42,129,"Westmoreland County, Pennsylvania",36758,15792,20966
77,PA,42,131,"Wyoming County, Pennsylvania",3030,1313,1717
78,PA,42,133,"York County, Pennsylvania",46124,19823,26301
7,RI,44,001,"Bristol County, Rhode Island",3396,1458,1938
8,RI,44,003,"Kent County, Rhode Island",13763,5821,7942
9,RI,44,005,"Newport County, Rhode Island",8005,3159,4846
10,RI,44,007,"Providence County, Rhode Island",107120,47085,60035
11,RI,44,009,"Washington County, Rhode Island",11939,5494,6445
12,SC,45,001,"Abbeville County, South Carolina",5471,2510,2961
13,SC,45,003,"Aiken County, South Carolina",29126,13078,16048
14,SC,45,005,"Allendale County, South Carolina",2537,1164,1373
15,SC,45,007,"Anderson County, South Carolina",30915,13201,17714
16,SC,45,009,"Bamberg County, South Carolina",4077,2090,1987
17,SC,45,011,"Barnwell County, South Carolina",5819,2287,3532
18,SC,45,013,"Beaufort County, South Carolina",21221,9021,12200
19,SC,45,015,"Berkeley County, South Carolina",26327,11742,14585
20,SC,45,017,"Calhoun County, South Carolina",2896,1389,1507
21,SC,45,019,"Charleston County, South Carolina",62119,26269,35850
22,SC,45,021,"Cherokee County, South Carolina",13093,5591,7502
23,SC,45,023,"Chester County, South Carolina",8734,3931,4803
24,SC,45,025,"Chesterfield County, South Carolina",11930,6027,5903
25,SC,45,027,"Clarendon County, South Carolina",8163,3623,4540
26,SC,45,029,"Colleton County, South Carolina",8340,3466,4874
27,SC,45,031,"Darlington County, South Carolina",15878,6580,9298
28,SC,45,033,"Dillon County, South Carolina",10502,4356,6146
29,SC,45,035,"Dorchester County, South Carolina",18737,7557,11180
30,SC,45,037,"Edgefield County, South Carolina",3896,1597,2299
31,SC,45,039,"Fairfield County, South Carolina",5566,2255,3311
32,SC,45,041,"Florence County, South Carolina",26802,11243,15559
33,SC,45,043,"Georgetown County, South Carolina",12557,5083,7474
34,SC,45,045,"Greenville County, South Carolina",72169,31335,40834
35,SC,45,047,"Greenwood County, South Carolina",15875,6825,9050
36,SC,45,049,"Hampton County, South Carolina",3963,1734,2229
37,SC,45,051,"Horry County, South Carolina",51988,23286,28702
38,SC,45,053,"Jasper County, South Carolina",6106,2888,3218
39,SC,45,055,"Kershaw County, South Carolina",10467,4672,5795
40,SC,45,057,"Lancaster County, South Carolina",14802,6340,8462
41,SC,45,059,"Laurens County, South Carolina",13395,5938,7457
42,SC,45,061,"Lee County, South Carolina",4663,2202,2461
43,SC,45,063,"Lexington County, South Carolina",38470,16614,21856
44,SC,45,065,"McCormick County, South Carolina",1681,741,940
45,SC,45,067,"Marion County, South Carolina",8865,3480,5385
46,SC,45,069,"Marlboro County, South Carolina",7224,3108,4116
47,SC,45,071,"Newberry County, South Carolina",6436,2717,3719
48,SC,45,073,"Oconee County, South Carolina",14897,6520,8377
49,SC,45,075,"Orangeburg County, South Carolina",20600,9050,11550
50,SC,45,077,"Pickens County, South Carolina",22545,10766,11779
51,SC,45,079,"Richland County, South Carolina",62611,26738,35873
52,SC,45,081,"Saluda County, South Carolina",4062,1813,2249
53,SC,45,083,"Spartanburg County, South Carolina",49665,21832,27833
54,SC,45,085,"Sumter County, South Carolina",18943,8146,10797
55,SC,45,087,"Union County, South Carolina",5605,2257,3348
56,SC,45,089,"Williamsburg County, South Carolina",9349,3950,5399
57,SC,45,091,"York County, South Carolina",31814,13652,18162
12,SD,46,003,"Aurora County, South Dakota",223,105,118
13,SD,46,005,"Beadle County, South Dakota",3708,1647,2061
14,SD,46,007,"Bennett County, South Dakota",1361,631,730
15,SD,46,009,"Bon Homme County, South Dakota",576,268,308
16,SD,46,011,"Brookings County, South Dakota",4811,2411,2400
17,SD,46,013,"Brown County, South Dakota",3613,1635,1978
18,SD,46,015,"Brule County, South Dakota",789,351,438
19,SD,46,017,"Buffalo County, South Dakota",711,362,349
20,SD,46,019,"Butte County, South Dakota",1082,514,568
21,SD,46,021,"Campbell County, South Dakota",140,58,82
22,SD,46,023,"Charles Mix County, South Dakota",1970,923,1047
23,SD,46,025,"Clark County, South Dakota",566,285,281
24,SD,46,027,"Clay County, South Dakota",3255,1660,1595
25,SD,46,029,"Codington County, South Dakota",2806,1298,1508
26,SD,46,031,"Corson County, South Dakota",1865,907,958
27,SD,46,033,"Custer County, South Dakota",850,373,477
28,SD,46,035,"Davison County, South Dakota",2379,1314,1065
29,SD,46,037,"Day County, South Dakota",1200,559,641
30,SD,46,039,"Deuel County, South Dakota",330,160,170
31,SD,46,041,"Dewey County, South Dakota",1523,728,795
32,SD,46,043,"Douglas County, South Dakota",246,72,174
33,SD,46,045,"Edmunds County, South Dakota",479,213,266
34,SD,46,047,"Fall River County, South Dakota",1097,543,554
35,SD,46,049,"Faulk County, South Dakota",373,244,129
36,SD,46,051,"Grant County, South Dakota",582,228,354
37,SD,46,053,"Gregory County, South Dakota",769,363,406
38,SD,46,055,"Haakon County, South Dakota",343,181,162
39,SD,46,057,"Hamlin County, South Dakota",424,176,248
40,SD,46,059,"Hand County, South Dakota",271,138,133
41,SD,46,061,"Hanson County, South Dakota",406,245,161
42,SD,46,063,"Harding County, South Dakota",174,85,89
43,SD,46,065,"Hughes County, South Dakota",1663,776,887
44,SD,46,067,"Hutchinson County, South Dakota",926,498,428
45,SD,46,069,"Hyde County, South Dakota",168,74,94
46,SD,46,071,"Jackson County, South Dakota",1059,511,548
47,SD,46,073,"Jerauld County, South Dakota",176,67,109
48,SD,46,075,"Jones County, South Dakota",89,49,40
49,SD,46,077,"Kingsbury County, South Dakota",505,219,286
50,SD,46,079,"Lake County, South Dakota",1732,766,966
51,SD,46,081,"Lawrence County, South Dakota",3115,1219,1896
52,SD,46,083,"Lincoln County, South Dakota",2158,859,1299
53,SD,46,085,"Lyman County, South Dakota",775,360,415
54,SD,46,087,"McCook County, South Dakota",467,218,249
55,SD,46,089,"McPherson County, South Dakota",478,306,172
56,SD,46,091,"Marshall County, South Dakota",701,296,405
57,SD,46,093,"Meade County, South Dakota",2764,1272,1492
58,SD,46,095,"Mellette County, South Dakota",921,437,484
59,SD,46,097,"Miner County, South Dakota",234,119,115
60,SD,46,099,"Minnehaha County, South Dakota",20578,9155,11423
61,SD,46,101,"Moody County, South Dakota",910,441,469
62,SD,46,102,"Oglala Lakota County, South Dakota",7482,3403,4079
63,SD,46,103,"Pennington County, South Dakota",13079,5673,7406
64,SD,46,105,"Perkins County, South Dakota",396,193,203
65,SD,46,107,"Potter County, South Dakota",255,141,114
66,SD,46,109,"Roberts County, South Dakota",2031,969,1062
67,SD,46,111,"Sanborn County, South Dakota",238,121,117
68,SD,46,115,"Spink County, South Dakota",798,340,458
69,SD,46,117,"Stanley County, South Dakota",240,94,146
70,SD,46,119,"Sully County, South Dakota",74,36,38
71,SD,46,121,"Todd County, South Dakota",4471,2116,2355
72,SD,46,123,"Tripp County, South Dakota",1212,535,677
73,SD,46,125,"Turner County, South Dakota",761,305,456
74,SD,46,127,"Union County, South Dakota",783,292,491
75,SD,46,129,"Walworth County, South Dakota",650,241,409
76,SD,46,135,"Yankton County, South Dakota",2993,1298,1695
77,SD,46,137,"Ziebach County, South Dakota",1103,507,596
12,TN,47,001,"Anderson County, Tennessee",13309,5830,7479
13,TN,47,003,"Bedford County, Tennessee",7727,3542,4185
14,TN,47,005,"Benton County, Tennessee",3667,1733,1934
15,TN,47,007,"Bledsoe County, Tennessee",2697,1234,1463
16,TN,47,009,"Blount County, Tennessee",17305,7389,9916
17,TN,47,011,"Bradley County, Tennessee",19357,8597,10760
18,TN,47,013,"Campbell County, Tennessee",9203,4004,5199
19,TN,47,015,"Cannon County, Tennessee",2500,1154,1346
20,TN,47,017,"Carroll County, Tennessee",5713,2656,3057
21,TN,47,019,"Carter County, Tennessee",13021,6094,6927
22,TN,47,021,"Cheatham County, Tennessee",5396,2410,2986
23,TN,47,023,"Chester County, Tennessee",3516,1579,1937
24,TN,47,025,"Claiborne County, Tennessee",6658,2951,3707
25,TN,47,027,"Clay County, Tennessee",1801,820,981
26,TN,47,029,"Cocke County, Tennessee",9111,4022,5089
27,TN,47,031,"Coffee County, Tennessee",9818,4470,5348
28,TN,47,033,"Crockett County, Tennessee",2838,1340,1498
29,TN,47,035,"Cumberland County, Tennessee",9300,4080,5220
30,TN,47,037,"Davidson County, Tennessee",116031,52503,63528
31,TN,47,039,"Decatur County, Tennessee",2470,1098,1372
32,TN,47,041,"DeKalb County, Tennessee",3887,1562,2325
33,TN,47,043,"Dickson County, Tennessee",8116,3460,4656
34,TN,47,045,"Dyer County, Tennessee",6646,2680,3966
35,TN,47,047,"Fayette County, Tennessee",5351,2427,2924
36,TN,47,049,"Fentress County, Tennessee",4577,2281,2296
37,TN,47,051,"Franklin County, Tennessee",6669,2889,3780
38,TN,47,053,"Gibson County, Tennessee",9080,3806,5274
39,TN,47,055,"Giles County, Tennessee",4627,2011,2616
40,TN,47,057,"Grainger County, Tennessee",4647,2091,2556
41,TN,47,059,"Greene County, Tennessee",13647,6146,7501
42,TN,47,061,"Grundy County, Tennessee",3797,1683,2114
43,TN,47,063,"Hamblen County, Tennessee",13193,6285,6908
44,TN,47,065,"Hamilton County, Tennessee",54036,23604,30432
45,TN,47,067,"Hancock County, Tennessee",1793,706,1087
46,TN,47,069,"Hardeman County, Tennessee",5636,2479,3157
47,TN,47,071,"Hardin County, Tennessee",5920,2494,3426
48,TN,47,073,"Hawkins County, Tennessee",10661,4410,6251
49,TN,47,075,"Haywood County, Tennessee",4107,1758,2349
50,TN,47,077,"Henderson County, Tennessee",5925,2512,3413
51,TN,47,079,"Henry County, Tennessee",5862,2421,3441
52,TN,47,081,"Hickman County, Tennessee",4738,2218,2520
53,TN,47,083,"Houston County, Tennessee",1860,949,911
54,TN,47,085,"Humphreys County, Tennessee",2856,1312,1544
55,TN,47,087,"Jackson County, Tennessee",3034,1443,1591
56,TN,47,089,"Jefferson County, Tennessee",8343,3626,4717
57,TN,47,091,"Johnson County, Tennessee",4123,1916,2207
58,TN,47,093,"Knox County, Tennessee",69061,31168,37893
59,TN,47,095,"Lake County, Tennessee",1319,538,781
60,TN,47,097,"Lauderdale County, Tennessee",6532,2877,3655
61,TN,47,099,"Lawrence County, Tennessee",8443,3608,4835
62,TN,47,101,"Lewis County, Tennessee",2292,1189,1103
63,TN,47,103,"Lincoln County, Tennessee",5517,2540,2977
64,TN,47,105,"Loudon County, Tennessee",7185,3503,3682
65,TN,47,107,"McMinn County, Tennessee",10220,4598,5622
66,TN,47,109,"McNairy County, Tennessee",5319,2199,3120
67,TN,47,111,"Macon County, Tennessee",4218,1836,2382
68,TN,47,113,"Madison County, Tennessee",18521,7912,10609
69,TN,47,115,"Marion County, Tennessee",5350,2191,3159
70,TN,47,117,"Marshall County, Tennessee",4986,2160,2826
71,TN,47,119,"Maury County, Tennessee",12667,5701,6966
72,TN,47,121,"Meigs County, Tennessee",2377,906,1471
73,TN,47,123,"Monroe County, Tennessee",8627,4032,4595
74,TN,47,125,"Montgomery County, Tennessee",28750,12557,16193
75,TN,47,127,"Moore County, Tennessee",668,268,400
76,TN,47,129,"Morgan County, Tennessee",4185,2019,2166
77,TN,47,131,"Obion County, Tennessee",6309,2881,3428
78,TN,47,133,"Overton County, Tennessee",4668,2273,2395
79,TN,47,135,"Perry County, Tennessee",1995,865,1130
80,TN,47,137,"Pickett County, Tennessee",808,315,493
81,TN,47,139,"Polk County, Tennessee",3094,1481,1613
82,TN,47,141,"Putnam County, Tennessee",17830,8209,9621
83,TN,47,143,"Rhea County, Tennessee",7664,3510,4154
84,TN,47,145,"Roane County, Tennessee",9620,4479,5141
85,TN,47,147,"Robertson County, Tennessee",8005,3441,4564
86,TN,47,149,"Rutherford County, Tennessee",34475,15822,18653
87,TN,47,151,"Scott County, Tennessee",5903,2663,3240
88,TN,47,153,"Sequatchie County, Tennessee",2335,979,1356
89,TN,47,155,"Sevier County, Tennessee",14128,6136,7992
90,TN,47,157,"Shelby County, Tennessee",196471,87291,109180
91,TN,47,159,"Smith County, Tennessee",3066,1307,1759
92,TN,47,161,"Stewart County, Tennessee",2560,1236,1324
93,TN,47,163,"Sullivan County, Tennessee",26924,12365,14559
94,TN,47,165,"Sumner County, Tennessee",15644,6676,8968
95,TN,47,167,"Tipton County, Tennessee",8292,3516,4776
96,TN,47,169,"Trousdale County, Tennessee",1345,614,731
97,TN,47,171,"Unicoi County, Tennessee",3974,1790,2184
98,TN,47,173,"Union County, Tennessee",4036,1575,2461
99,TN,47,175,"Van Buren County, Tennessee",988,523,465
100,TN,47,177,"Warren County, Tennessee",8329,3964,4365
101,TN,47,179,"Washington County, Tennessee",21842,9588,12254
102,TN,47,181,"Wayne County, Tennessee",3211,1619,1592
103,TN,47,183,"Weakley County, Tennessee",6075,2810,3265
104,TN,47,185,"White County, Tennessee",5011,2341,2670
105,TN,47,187,"Williamson County, Tennessee",10054,4225,5829
106,TN,47,189,"Wilson County, Tennessee",12132,4886,7246
12,TX,48,001,"Anderson County, Texas",8274,3779,4495
13,TX,48,003,"Andrews County, Texas",2032,832,1200
14,TX,48,005,"Angelina County, Texas",16497,7061,9436
15,TX,48,007,"Aransas County, Texas",4509,2097,2412
16,TX,48,009,"Archer County, Texas",862,352,510
17,TX,48,011,"Armstrong County, Texas",130,49,81
18,TX,48,013,"Atascosa County, Texas",7619,3141,4478
19,TX,48,015,"Austin County, Texas",3289,1377,1912
20,TX,48,017,"Bailey County, Texas",1319,500,819
21,TX,48,019,"Bandera County, Texas",2662,1322,1340
22,TX,48,021,"Bastrop County, Texas",10664,4867,5797
23,TX,48,023,"Baylor County, Texas",423,143,280
24,TX,48,025,"Bee County, Texas",5274,2344,2930
25,TX,48,027,"Bell County, Texas",48543,21926,26617
26,TX,48,029,"Bexar County, Texas",312088,140680,171408
27,TX,48,031,"Blanco County, Texas",954,451,503
28,TX,48,033,"Borden County, Texas",10,5,5
29,TX,48,035,"Bosque County, Texas",2549,1144,1405
30,TX,48,037,"Bowie County, Texas",16693,7537,9156
31,TX,48,039,"Brazoria County, Texas",35762,16016,19746
32,TX,48,041,"Brazos County, Texas",53207,25213,27994
33,TX,48,043,"Brewster County, Texas",1238,508,730
34,TX,48,045,"Briscoe County, Texas",307,156,151
35,TX,48,047,"Brooks County, Texas",2726,1476,1250
36,TX,48,049,"Brown County, Texas",6581,2868,3713
37,TX,48,051,"Burleson County, Texas",2761,1259,1502
38,TX,48,053,"Burnet County, Texas",6989,3317,3672
39,TX,48,055,"Caldwell County, Texas",7169,3540,3629
40,TX,48,057,"Calhoun County, Texas",4136,1987,2149
41,TX,48,059,"Callahan County, Texas",2548,1107,1441
42,TX,48,061,"Cameron County, Texas",139768,63753,76015
43,TX,48,063,"Camp County, Texas",2454,1046,1408
44,TX,48,065,"Carson County, Texas",435,202,233
45,TX,48,067,"Cass County, Texas",5915,2548,3367
46,TX,48,069,"Castro County, Texas",1339,672,667
47,TX,48,071,"Chambers County, Texas",3921,1677,2244
48,TX,48,073,"Cherokee County, Texas",10688,4875,5813
49,TX,48,075,"Childress County, Texas",1177,573,604
50,TX,48,077,"Clay County, Texas",1246,620,626
51,TX,48,079,"Cochran County, Texas",591,267,324
52,TX,48,081,"Coke County, Texas",361,152,209
53,TX,48,083,"Coleman County, Texas",1924,720,1204
54,TX,48,085,"Collin County, Texas",64824,30107,34717
55,TX,48,087,"Collingsworth County, Texas",675,229,446
56,TX,48,089,"Colorado County, Texas",3081,1430,1651
57,TX,48,091,"Comal County, Texas",10423,4122,6301
58,TX,48,093,"Comanche County, Texas",3107,1420,1687
59,TX,48,095,"Concho County, Texas",298,81,217
60,TX,48,097,"Cooke County, Texas",5292,2322,2970
61,TX,48,099,"Coryell County, Texas",8631,3528,5103
62,TX,48,101,"Cottle County, Texas",340,167,173
63,TX,48,103,"Crane County, Texas",606,236,370
64,TX,48,105,"Crockett County, Texas",635,239,396
65,TX,48,107,"Crosby County, Texas",1358,544,814
66,TX,48,109,"Culberson County, Texas",677,307,370
67,TX,48,111,"Dallam County, Texas",1183,511,672
68,TX,48,113,"Dallas County, Texas",472926,211723,261203
69,TX,48,115,"Dawson County, Texas",1924,729,1195
70,TX,48,117,"Deaf Smith County, Texas",3955,1687,2268
71,TX,48,119,"Delta County, Texas",1177,554,623
72,TX,48,121,"Denton County, Texas",63220,27578,35642
73,TX,48,123,"DeWitt County, Texas",2817,1289,1528
74,TX,48,125,"Dickens County, Texas",417,192,225
75,TX,48,127,"Dimmit County, Texas",2003,721,1282
76,TX,48,129,"Donley County, Texas",585,247,338
77,TX,48,131,"Duval County, Texas",2617,1093,1524
78,TX,48,133,"Eastland County, Texas",3162,1312,1850
79,TX,48,135,"Ector County, Texas",19162,7745,11417
80,TX,48,137,"Edwards County, Texas",205,105,100
81,TX,48,139,"Ellis County, Texas",18755,8310,10445
82,TX,48,141,"El Paso County, Texas",185728,81700,104028
83,TX,48,143,"Erath County, Texas",9340,3732,5608
84,TX,48,145,"Falls County, Texas",3417,1589,1828
85,TX,48,147,"Fannin County, Texas",5305,2544,2761
86,TX,48,149,"Fayette County, Texas",3021,1282,1739
87,TX,48,151,"Fisher County, Texas",666,252,414
88,TX,48,153,"Floyd County, Texas",1375,613,762
89,TX,48,155,"Foard County, Texas",114,52,62
90,TX,48,157,"Fort Bend County, Texas",53761,23618,30143
91,TX,48,159,"Franklin County, Texas",1726,878,848
92,TX,48,161,"Freestone County, Texas",2683,1178,1505
93,TX,48,163,"Frio County, Texas",3321,1607,1714
94,TX,48,165,"Gaines County, Texas",2177,1018,1159
95,TX,48,167,"Galveston County, Texas",41985,18622,23363
96,TX,48,169,"Garza County, Texas",432,204,228
97,TX,48,171,"Gillespie County, Texas",2791,1403,1388
98,TX,48,173,"Glasscock County, Texas",40,20,20
99,TX,48,175,"Goliad County, Texas",1358,685,673
100,TX,48,177,"Gonzales County, Texas",4009,1702,2307
101,TX,48,179,"Gray County, Texas",2824,1266,1558
102,TX,48,181,"Grayson County, Texas",19420,8783,10637
103,TX,48,183,"Gregg County, Texas",21769,9209,12560
104,TX,48,185,"Grimes County, Texas",4701,2278,2423
105,TX,48,187,"Guadalupe County, Texas",13924,5939,7985
106,TX,48,189,"Hale County, Texas",7548,3137,4411
107,TX,48,191,"Hall County, Texas",844,417,427
108,TX,48,193,"Hamilton County, Texas",1159,545,614
109,TX,48,195,"Hansford County, Texas",939,455,484
110,TX,48,197,"Hardeman County, Texas",585,284,301
111,TX,48,199,"Hardin County, Texas",6684,2682,4002
112,TX,48,201,"Harris County, Texas",774568,348592,425976
113,TX,48,203,"Harrison County, Texas",11151,5009,6142
114,TX,48,205,"Hartley County, Texas",295,123,172
115,TX,48,207,"Haskell County, Texas",1030,467,563
116,TX,48,209,"Hays County, Texas",28783,12839,15944
117,TX,48,211,"Hemphill County, Texas",502,266,236
118,TX,48,213,"Henderson County, Texas",14572,6271,8301
119,TX,48,215,"Hidalgo County, Texas",277104,126943,150161
120,TX,48,217,"Hill County, Texas",7049,3091,3958
121,TX,48,219,"Hockley County, Texas",3297,1407,1890
122,TX,48,221,"Hood County, Texas",6161,2476,3685
123,TX,48,223,"Hopkins County, Texas",6972,2980,3992
124,TX,48,225,"Houston County, Texas",4918,1850,3068
125,TX,48,227,"Howard County, Texas",4787,1873,2914
126,TX,48,229,"Hudspeth County, Texas",1192,491,701
127,TX,48,231,"Hunt County, Texas",16112,7513,8599
128,TX,48,233,"Hutchinson County, Texas",3493,1394,2099
129,TX,48,235,"Irion County, Texas",191,84,107
130,TX,48,237,"Jack County, Texas",1324,576,748
131,TX,48,239,"Jackson County, Texas",1765,582,1183
132,TX,48,241,"Jasper County, Texas",5912,2342,3570
133,TX,48,243,"Jeff Davis County, Texas",123,60,63
134,TX,48,245,"Jefferson County, Texas",47095,19637,27458
135,TX,48,247,"Jim Hogg County, Texas",915,479,436
136,TX,48,249,"Jim Wells County, Texas",9128,4274,4854
137,TX,48,251,"Johnson County, Texas",18392,7958,10434
138,TX,48,253,"Jones County, Texas",2285,894,1391
139,TX,48,255,"Karnes County, Texas",3079,1427,1652
140,TX,48,257,"Kaufman County, Texas",15016,6368,8648
141,TX,48,259,"Kendall County, Texas",2862,1312,1550
142,TX,48,261,"Kenedy County, Texas",151,67,84
143,TX,48,263,"Kent County, Texas",74,31,43
144,TX,48,265,"Kerr County, Texas",7718,3243,4475
145,TX,48,267,"Kimble County, Texas",912,401,511
146,TX,48,269,"King County, Texas",19,10,9
147,TX,48,271,"Kinney County, Texas",572,280,292
148,TX,48,273,"Kleberg County, Texas",7849,3836,4013
149,TX,48,275,"Knox County, Texas",605,223,382
150,TX,48,277,"Lamar County, Texas",9076,3850,5226
151,TX,48,279,"Lamb County, Texas",3173,1511,1662
152,TX,48,281,"Lampasas County, Texas",2923,1347,1576
153,TX,48,283,"La Salle County, Texas",972,456,516
154,TX,48,285,"Lavaca County, Texas",1765,684,1081
155,TX,48,287,"Lee County, Texas",2374,1078,1296
156,TX,48,289,"Leon County, Texas",2322,990,1332
157,TX,48,291,"Liberty County, Texas",12548,5484,7064
158,TX,48,293,"Limestone County, Texas",5189,2600,2589
159,TX,48,295,"Lipscomb County, Texas",317,120,197
160,TX,48,297,"Live Oak County, Texas",1567,738,829
161,TX,48,299,"Llano County, Texas",2841,1108,1733
162,TX,48,301,"Loving County, Texas",33,24,9
163,TX,48,303,"Lubbock County, Texas",54155,24959,29196
164,TX,48,305,"Lynn County, Texas",1106,451,655
165,TX,48,307,"McCulloch County, Texas",1522,645,877
166,TX,48,309,"McLennan County, Texas",49881,22723,27158
167,TX,48,311,"McMullen County, Texas",92,45,47
168,TX,48,313,"Madison County, Texas",1938,925,1013
169,TX,48,315,"Marion County, Texas",2264,742,1522
170,TX,48,317,"Martin County, Texas",692,335,357
171,TX,48,319,"Mason County, Texas",577,284,293
172,TX,48,321,"Matagorda County, Texas",7833,3539,4294
173,TX,48,323,"Maverick County, Texas",14872,6275,8597
174,TX,48,325,"Medina County, Texas",6656,2989,3667
175,TX,48,327,"Menard County, Texas",317,114,203
176,TX,48,329,"Midland County, Texas",13238,5140,8098
177,TX,48,331,"Milam County, Texas",4159,1650,2509
178,TX,48,333,"Mills County, Texas",688,223,465
179,TX,48,335,"Mitchell County, Texas",766,274,492
180,TX,48,337,"Montague County, Texas",2878,1274,1604
181,TX,48,339,"Montgomery County, Texas",59856,27146,32710
182,TX,48,341,"Moore County, Texas",4421,2081,2340
183,TX,48,343,"Morris County, Texas",2346,1000,1346
184,TX,48,345,"Motley County, Texas",181,89,92
185,TX,48,347,"Nacogdoches County, Texas",14752,6761,7991
186,TX,48,349,"Navarro County, Texas",9794,4323,5471
187,TX,48,351,"Newton County, Texas",1798,877,921
188,TX,48,353,"Nolan County, Texas",3108,1410,1698
189,TX,48,355,"Nueces County, Texas",61965,27065,34900
190,TX,48,357,"Ochiltree County, Texas",1447,605,842
191,TX,48,359,"Oldham County, Texas",214,72,142
192,TX,48,361,"Orange County, Texas",12691,5723,6968
193,TX,48,363,"Palo Pinto County, Texas",5425,2473,2952
194,TX,48,365,"Panola County, Texas",3509,1196,2313
195,TX,48,367,"Parker County, Texas",11785,4602,7183
196,TX,48,369,"Parmer County, Texas",1696,751,945
197,TX,48,371,"Pecos County, Texas",1643,728,915
198,TX,48,373,"Polk County, Texas",7279,3252,4027
199,TX,48,375,"Potter County, Texas",25466,10956,14510
200,TX,48,377,"Presidio County, Texas",1586,643,943
201,TX,48,379,"Rains County, Texas",1206,514,692
202,TX,48,381,"Randall County, Texas",13076,5425,7651
203,TX,48,383,"Reagan County, Texas",552,277,275
204,TX,48,385,"Real County, Texas",541,242,299
205,TX,48,387,"Red River County, Texas",2321,1053,1268
206,TX,48,389,"Reeves County, Texas",1895,825,1070
207,TX,48,391,"Refugio County, Texas",1203,573,630
208,TX,48,393,"Roberts County, Texas",14,9,5
209,TX,48,395,"Robertson County, Texas",2841,1286,1555
210,TX,48,397,"Rockwall County, Texas",5310,2397,2913
211,TX,48,399,"Runnels County, Texas",2071,964,1107
212,TX,48,401,"Rusk County, Texas",8510,3598,4912
213,TX,48,403,"Sabine County, Texas",2840,1363,1477
214,TX,48,405,"San Augustine County, Texas",2105,978,1127
215,TX,48,407,"San Jacinto County, Texas",5419,2160,3259
216,TX,48,409,"San Patricio County, Texas",9949,4153,5796
217,TX,48,411,"San Saba County, Texas",792,416,376
218,TX,48,413,"Schleicher County, Texas",630,214,416
219,TX,48,415,"Scurry County, Texas",1527,555,972
220,TX,48,417,"Shackelford County, Texas",635,340,295
221,TX,48,419,"Shelby County, Texas",5553,2706,2847
222,TX,48,421,"Sherman County, Texas",376,117,259
223,TX,48,423,"Smith County, Texas",37048,16944,20104
224,TX,48,425,"Somervell County, Texas",1158,406,752
225,TX,48,427,"Starr County, Texas",22663,9955,12708
226,TX,48,429,"Stephens County, Texas",1751,749,1002
227,TX,48,431,"Sterling County, Texas",208,100,108
228,TX,48,433,"Stonewall County, Texas",264,155,109
229,TX,48,435,"Sutton County, Texas",328,151,177
230,TX,48,437,"Swisher County, Texas",1595,708,887
231,TX,48,439,"Tarrant County, Texas",283264,129036,154228
232,TX,48,441,"Taylor County, Texas",22395,9712,12683
233,TX,48,443,"Terrell County, Texas",186,58,128
234,TX,48,445,"Terry County, Texas",1756,726,1030
235,TX,48,447,"Throckmorton County, Texas",199,81,118
236,TX,48,449,"Titus County, Texas",6848,3136,3712
237,TX,48,451,"Tom Green County, Texas",16202,7037,9165
238,TX,48,453,"Travis County, Texas",180220,84267,95953
239,TX,48,455,"Trinity County, Texas",2381,1166,1215
240,TX,48,457,"Tyler County, Texas",3159,1489,1670
241,TX,48,459,"Upshur County, Texas",5322,2251,3071
242,TX,48,461,"Upton County, Texas",657,278,379
243,TX,48,463,"Uvalde County, Texas",5248,2307,2941
244,TX,48,465,"Val Verde County, Texas",9738,4303,5435
245,TX,48,467,"Van Zandt County, Texas",8787,3991,4796
246,TX,48,469,"Victoria County, Texas",14531,6219,8312
247,TX,48,471,"Walker County, Texas",12642,5139,7503
248,TX,48,473,"Waller County, Texas",7505,3529,3976
249,TX,48,475,"Ward County, Texas",1831,905,926
250,TX,48,477,"Washington County, Texas",4325,1895,2430
251,TX,48,479,"Webb County, Texas",82307,36856,45451
252,TX,48,481,"Wharton County, Texas",7178,3232,3946
253,TX,48,483,"Wheeler County, Texas",862,419,443
254,TX,48,485,"Wichita County, Texas",20712,8817,11895
255,TX,48,487,"Wilbarger County, Texas",2275,1155,1120
256,TX,48,489,"Willacy County, Texas",7604,3426,4178
257,TX,48,491,"Williamson County, Texas",35014,15936,19078
258,TX,48,493,"Wilson County, Texas",4783,2127,2656
259,TX,48,495,"Winkler County, Texas",1040,370,670
260,TX,48,497,"Wise County, Texas",7015,2646,4369
261,TX,48,499,"Wood County, Texas",6073,2621,3452
262,TX,48,501,"Yoakum County, Texas",979,308,671
263,TX,48,503,"Young County, Texas",2751,1308,1443
264,TX,48,505,"Zapata County, Texas",5334,2552,2782
265,TX,48,507,"Zavala County, Texas",3943,1409,2534
12,UT,49,001,"Beaver County, Utah",797,374,423
13,UT,49,003,"Box Elder County, Utah",4779,2317,2462
14,UT,49,005,"Cache County, Utah",17713,8262,9451
15,UT,49,007,"Carbon County, Utah",3113,1350,1763
16,UT,49,009,"Daggett County, Utah",47,11,36
17,UT,49,011,"Davis County, Utah",24718,10960,13758
18,UT,49,013,"Duchesne County, Utah",2019,821,1198
19,UT,49,015,"Emery County, Utah",1188,482,706
20,UT,49,017,"Garfield County, Utah",873,358,515
21,UT,49,019,"Grand County, Utah",1740,877,863
22,UT,49,021,"Iron County, Utah",9727,4998,4729
23,UT,49,023,"Juab County, Utah",1464,746,718
24,UT,49,025,"Kane County, Utah",562,233,329
25,UT,49,027,"Millard County, Utah",1602,713,889
26,UT,49,029,"Morgan County, Utah",557,262,295
27,UT,49,031,"Piute County, Utah",376,190,186
28,UT,49,033,"Rich County, Utah",333,115,218
29,UT,49,035,"Salt Lake County, Utah",131630,61427,70203
30,UT,49,037,"San Juan County, Utah",4149,1972,2177
31,UT,49,039,"Sanpete County, Utah",4043,1618,2425
32,UT,49,041,"Sevier County, Utah",2973,1222,1751
33,UT,49,043,"Summit County, Utah",3001,1546,1455
34,UT,49,045,"Tooele County, Utah",4339,1877,2462
35,UT,49,047,"Uintah County, Utah",3261,1530,1731
36,UT,49,049,"Utah County, Utah",71110,33388,37722
37,UT,49,051,"Wasatch County, Utah",2633,1199,1434
38,UT,49,053,"Washington County, Utah",21893,10244,11649
39,UT,49,055,"Wayne County, Utah",414,214,200
40,UT,49,057,"Weber County, Utah",30547,14446,16101
12,VA,51,001,"Accomack County, Virginia",6384,2475,3909
13,VA,51,003,"Albemarle County, Virginia",9714,4431,5283
14,VA,51,005,"Alleghany County, Virginia",2682,1184,1498
15,VA,51,007,"Amelia County, Virginia",1471,792,679
16,VA,51,009,"Amherst County, Virginia",4086,2099,1987
17,VA,51,011,"Appomattox County, Virginia",2668,1172,1496
18,VA,51,013,"Arlington County, Virginia",19996,9134,10862
19,VA,51,015,"Augusta County, Virginia",6694,2535,4159
20,VA,51,017,"Bath County, Virginia",347,185,162
21,VA,51,019,"Bedford County, Virginia",7372,3436,3936
22,VA,51,021,"Bland County, Virginia",621,287,334
23,VA,51,023,"Botetourt County, Virginia",2701,1248,1453
24,VA,51,025,"Brunswick County, Virginia",3298,1396,1902
25,VA,51,027,"Buchanan County, Virginia",5841,2717,3124
26,VA,51,029,"Buckingham County, Virginia",2867,1283,1584
27,VA,51,031,"Campbell County, Virginia",7309,3096,4213
28,VA,51,033,"Caroline County, Virginia",3601,1521,2080
29,VA,51,035,"Carroll County, Virginia",5017,2237,2780
30,VA,51,036,"Charles City County, Virginia",933,379,554
31,VA,51,037,"Charlotte County, Virginia",2589,1050,1539
32,VA,51,041,"Chesterfield County, Virginia",24002,10156,13846
33,VA,51,043,"Clarke County, Virginia",1556,734,822
34,VA,51,045,"Craig County, Virginia",611,218,393
35,VA,51,047,"Culpeper County, Virginia",4320,1806,2514
36,VA,51,049,"Cumberland County, Virginia",1996,1065,931
37,VA,51,051,"Dickenson County, Virginia",3225,1513,1712
38,VA,51,053,"Dinwiddie County, Virginia",4061,1686,2375
39,VA,51,057,"Essex County, Virginia",1533,584,949
40,VA,51,059,"Fairfax County, Virginia",66762,29498,37264
41,VA,51,061,"Fauquier County, Virginia",3762,1662,2100
42,VA,51,063,"Floyd County, Virginia",1551,803,748
43,VA,51,065,"Fluvanna County, Virginia",1618,666,952
44,VA,51,067,"Franklin County, Virginia",8123,3695,4428
45,VA,51,069,"Frederick County, Virginia",5247,2162,3085
46,VA,51,071,"Giles County, Virginia",1891,851,1040
47,VA,51,073,"Gloucester County, Virginia",2735,1165,1570
48,VA,51,075,"Goochland County, Virginia",1163,520,643
49,VA,51,077,"Grayson County, Virginia",3244,1359,1885
50,VA,51,079,"Greene County, Virginia",1853,751,1102
51,VA,51,081,"Greensville County, Virginia",1490,497,993
52,VA,51,083,"Halifax County, Virginia",6675,3041,3634
53,VA,51,085,"Hanover County, Virginia",5976,2392,3584
54,VA,51,087,"Henrico County, Virginia",33914,14118,19796
55,VA,51,089,"Henry County, Virginia",9520,4167,5353
56,VA,51,091,"Highland County, Virginia",282,88,194
57,VA,51,093,"Isle of Wight County, Virginia",4137,1943,2194
58,VA,51,095,"James City County, Virginia",5648,2559,3089
59,VA,51,097,"King and Queen County, Virginia",949,470,479
60,VA,51,099,"King George County, Virginia",1366,522,844
61,VA,51,101,"King William County, Virginia",1897,835,1062
62,VA,51,103,"Lancaster County, Virginia",1246,551,695
63,VA,51,105,"Lee County, Virginia",6027,2490,3537
64,VA,51,107,"Loudoun County, Virginia",14047,5850,8197
65,VA,51,109,"Louisa County, Virginia",3385,1584,1801
66,VA,51,111,"Lunenburg County, Virginia",2279,1015,1264
67,VA,51,113,"Madison County, Virginia",1613,725,888
68,VA,51,115,"Mathews County, Virginia",613,274,339
69,VA,51,117,"Mecklenburg County, Virginia",5975,2697,3278
70,VA,51,119,"Middlesex County, Virginia",982,462,520
71,VA,51,121,"Montgomery County, Virginia",21707,11805,9902
72,VA,51,125,"Nelson County, Virginia",2159,1131,1028
73,VA,51,127,"New Kent County, Virginia",1327,485,842
74,VA,51,131,"Northampton County, Virginia",2730,1193,1537
75,VA,51,133,"Northumberland County, Virginia",1352,537,815
76,VA,51,135,"Nottoway County, Virginia",3444,1760,1684
77,VA,51,137,"Orange County, Virginia",4105,1637,2468
78,VA,51,139,"Page County, Virginia",3880,1813,2067
79,VA,51,141,"Patrick County, Virginia",3818,1918,1900
80,VA,51,143,"Pittsylvania County, Virginia",9944,3897,6047
81,VA,51,145,"Powhatan County, Virginia",1252,476,776
82,VA,51,147,"Prince Edward County, Virginia",3883,1503,2380
83,VA,51,149,"Prince George County, Virginia",3370,1612,1758
84,VA,51,153,"Prince William County, Virginia",28739,12982,15757
85,VA,51,155,"Pulaski County, Virginia",4506,2063,2443
86,VA,51,157,"Rappahannock County, Virginia",733,323,410
87,VA,51,159,"Richmond County, Virginia",748,289,459
88,VA,51,161,"Roanoke County, Virginia",7607,3482,4125
89,VA,51,163,"Rockbridge County, Virginia",3085,1379,1706
90,VA,51,165,"Rockingham County, Virginia",8471,3839,4632
91,VA,51,167,"Russell County, Virginia",5777,2322,3455
92,VA,51,169,"Scott County, Virginia",4406,1945,2461
93,VA,51,171,"Shenandoah County, Virginia",5138,2009,3129
94,VA,51,173,"Smyth County, Virginia",5815,2757,3058
95,VA,51,175,"Southampton County, Virginia",2649,1175,1474
96,VA,51,177,"Spotsylvania County, Virginia",10396,4565,5831
97,VA,51,179,"Stafford County, Virginia",6948,2928,4020
98,VA,51,181,"Surry County, Virginia",881,403,478
99,VA,51,183,"Sussex County, Virginia",1362,439,923
100,VA,51,185,"Tazewell County, Virginia",7518,3186,4332
101,VA,51,187,"Warren County, Virginia",3696,1533,2163
102,VA,51,191,"Washington County, Virginia",6845,3161,3684
103,VA,51,193,"Westmoreland County, Virginia",2323,1045,1278
104,VA,51,195,"Wise County, Virginia",8414,3646,4768
105,VA,51,197,"Wythe County, Virginia",4356,2050,2306
106,VA,51,199,"York County, Virginia",4198,1815,2383
107,VA,51,510,"Alexandria city, Virginia",12359,4903,7456
108,VA,51,520,"Bristol city, Virginia",3496,1410,2086
109,VA,51,530,"Buena Vista city, Virginia",1755,529,1226
110,VA,51,540,"Charlottesville city, Virginia",10995,5182,5813
111,VA,51,550,"Chesapeake city, Virginia",21734,8627,13107
112,VA,51,570,"Colonial Heights city, Virginia",1974,837,1137
113,VA,51,580,"Covington city, Virginia",1437,587,850
114,VA,51,590,"Danville city, Virginia",9629,4000,5629
115,VA,51,595,"Emporia city, Virginia",1907,862,1045
116,VA,51,600,"Fairfax city, Virginia",1593,831,762
117,VA,51,610,"Falls Church city, Virginia",361,124,237
118,VA,51,620,"Franklin city, Virginia",1762,962,800
119,VA,51,630,"Fredericksburg city, Virginia",4108,1727,2381
120,VA,51,640,"Galax city, Virginia",1766,913,853
121,VA,51,650,"Hampton city, Virginia",20187,8590,11597
122,VA,51,660,"Harrisonburg city, Virginia",14326,6628,7698
123,VA,51,670,"Hopewell city, Virginia",4165,1792,2373
124,VA,51,678,"Lexington city, Virginia",678,205,473
125,VA,51,680,"Lynchburg city, Virginia",16775,7243,9532
126,VA,51,683,"Manassas city, Virginia",3945,1572,2373
127,VA,51,685,"Manassas Park city, Virginia",1232,646,586
128,VA,51,690,"Martinsville city, Virginia",3105,1269,1836
129,VA,51,700,"Newport News city, Virginia",26984,11787,15197
130,VA,51,710,"Norfolk city, Virginia",46288,21633,24655
131,VA,51,720,"Norton city, Virginia",949,369,580
132,VA,51,730,"Petersburg city, Virginia",8795,3584,5211
133,VA,51,735,"Poquoson city, Virginia",502,134,368
134,VA,51,740,"Portsmouth city, Virginia",17000,6563,10437
135,VA,51,750,"Radford city, Virginia",5497,2608,2889
136,VA,51,760,"Richmond city, Virginia",51828,22792,29036
137,VA,51,770,"Roanoke city, Virginia",20514,8945,11569
138,VA,51,775,"Salem city, Virginia",2578,1082,1496
139,VA,51,790,"Staunton city, Virginia",4052,1677,2375
140,VA,51,800,"Suffolk city, Virginia",9835,4190,5645
141,VA,51,810,"Virginia Beach city, Virginia",36267,15055,21212
142,VA,51,820,"Waynesboro city, Virginia",3796,1496,2300
143,VA,51,830,"Williamsburg city, Virginia",2401,1108,1293
144,VA,51,840,"Winchester city, Virginia",4200,1784,2416
12,VT,50,001,"Addison County, Vermont",3124,1498,1626
13,VT,50,003,"Bennington County, Vermont",4735,2226,2509
14,VT,50,005,"Caledonia County, Vermont",3733,1458,2275
15,VT,50,007,"Chittenden County, Vermont",17045,7513,9532
16,VT,50,009,"Essex County, Vermont",929,412,517
17,VT,50,011,"Franklin County, Vermont",4147,1893,2254
18,VT,50,013,"Grand Isle County, Vermont",598,275,323
19,VT,50,015,"Lamoille County, Vermont",2887,1126,1761
20,VT,50,017,"Orange County, Vermont",3498,1601,1897
21,VT,50,019,"Orleans County, Vermont",4070,1866,2204
22,VT,50,021,"Rutland County, Vermont",7276,3507,3769
23,VT,50,023,"Washington County, Vermont",5729,2530,3199
24,VT,50,025,"Windham County, Vermont",5421,2361,3060
25,VT,50,027,"Windsor County, Vermont",6041,2725,3316
12,WA,53,001,"Adams County, Washington",4019,1948,2071
13,WA,53,003,"Asotin County, Washington",3301,1474,1827
14,WA,53,005,"Benton County, Washington",26013,11805,14208
15,WA,53,007,"Chelan County, Washington",10466,4799,5667
16,WA,53,009,"Clallam County, Washington",10682,4864,5818
17,WA,53,011,"Clark County, Washington",49314,21861,27453
18,WA,53,013,"Columbia County, Washington",690,357,333
19,WA,53,015,"Cowlitz County, Washington",17609,8049,9560
20,WA,53,017,"Douglas County, Washington",5835,2677,3158
21,WA,53,019,"Ferry County, Washington",1659,906,753
22,WA,53,021,"Franklin County, Washington",15406,7067,8339
23,WA,53,023,"Garfield County, Washington",252,95,157
24,WA,53,025,"Grant County, Washington",16295,7498,8797
25,WA,53,027,"Grays Harbor County, Washington",12357,5580,6777
26,WA,53,029,"Island County, Washington",7430,3115,4315
27,WA,53,031,"Jefferson County, Washington",3508,1500,2008
28,WA,53,033,"King County, Washington",226204,105541,120663
29,WA,53,035,"Kitsap County, Washington",26349,11851,14498
30,WA,53,037,"Kittitas County, Washington",8804,3868,4936
31,WA,53,039,"Klickitat County, Washington",3150,1141,2009
32,WA,53,041,"Lewis County, Washington",12126,5448,6678
33,WA,53,043,"Lincoln County, Washington",1562,720,842
34,WA,53,045,"Mason County, Washington",10166,5632,4534
35,WA,53,047,"Okanogan County, Washington",8646,4399,4247
36,WA,53,049,"Pacific County, Washington",3918,1788,2130
37,WA,53,051,"Pend Oreille County, Washington",2753,1293,1460
38,WA,53,053,"Pierce County, Washington",102233,45865,56368
39,WA,53,055,"San Juan County, Washington",1823,731,1092
40,WA,53,057,"Skagit County, Washington",18815,8499,10316
41,WA,53,059,"Skamania County, Washington",1526,627,899
42,WA,53,061,"Snohomish County, Washington",74826,33579,41247
43,WA,53,063,"Spokane County, Washington",74110,35552,38558
44,WA,53,065,"Stevens County, Washington",7753,3573,4180
45,WA,53,067,"Thurston County, Washington",32101,14506,17595
46,WA,53,069,"Wahkiakum County, Washington",674,298,376
47,WA,53,071,"Walla Walla County, Washington",9535,4153,5382
48,WA,53,073,"Whatcom County, Washington",32328,14556,17772
49,WA,53,075,"Whitman County, Washington",12580,6698,5882
50,WA,53,077,"Yakima County, Washington",51694,23973,27721
12,WI,55,001,"Adams County, Wisconsin",2704,1437,1267
13,WI,55,003,"Ashland County, Wisconsin",2398,1017,1381
14,WI,55,005,"Barron County, Wisconsin",5640,2618,3022
15,WI,55,007,"Bayfield County, Wisconsin",1719,772,947
16,WI,55,009,"Brown County, Wisconsin",28969,12381,16588
17,WI,55,011,"Buffalo County, Wisconsin",1500,716,784
18,WI,55,013,"Burnett County, Wisconsin",2371,1171,1200
19,WI,55,015,"Calumet County, Wisconsin",3434,1377,2057
20,WI,55,017,"Chippewa County, Wisconsin",6081,2915,3166
21,WI,55,019,"Clark County, Wisconsin",5504,2419,3085
22,WI,55,021,"Columbia County, Wisconsin",4844,2124,2720
23,WI,55,023,"Crawford County, Wisconsin",2023,869,1154
24,WI,55,025,"Dane County, Wisconsin",64062,28989,35073
25,WI,55,027,"Dodge County, Wisconsin",7658,3436,4222
26,WI,55,029,"Door County, Wisconsin",2766,1255,1511
27,WI,55,031,"Douglas County, Wisconsin",6713,3156,3557
28,WI,55,033,"Dunn County, Wisconsin",6140,2632,3508
29,WI,55,035,"Eau Claire County, Wisconsin",14862,6739,8123
30,WI,55,037,"Florence County, Wisconsin",409,160,249
31,WI,55,039,"Fond du Lac County, Wisconsin",9071,3932,5139
32,WI,55,041,"Forest County, Wisconsin",1505,729,776
33,WI,55,043,"Grant County, Wisconsin",7318,3707,3611
34,WI,55,045,"Green County, Wisconsin",3253,1413,1840
35,WI,55,047,"Green Lake County, Wisconsin",2274,1143,1131
36,WI,55,049,"Iowa County, Wisconsin",2448,1154,1294
37,WI,55,051,"Iron County, Wisconsin",653,277,376
38,WI,55,053,"Jackson County, Wisconsin",2810,1234,1576
39,WI,55,055,"Jefferson County, Wisconsin",8597,3917,4680
40,WI,55,057,"Juneau County, Wisconsin",3567,1754,1813
41,WI,55,059,"Kenosha County, Wisconsin",24823,11271,13552
42,WI,55,061,"Kewaunee County, Wisconsin",1800,762,1038
43,WI,55,063,"La Crosse County, Wisconsin",16616,7106,9510
44,WI,55,065,"Lafayette County, Wisconsin",1800,809,991
45,WI,55,067,"Langlade County, Wisconsin",3063,1523,1540
46,WI,55,069,"Lincoln County, Wisconsin",2800,1249,1551
47,WI,55,071,"Manitowoc County, Wisconsin",7957,3304,4653
48,WI,55,073,"Marathon County, Wisconsin",14095,6537,7558
49,WI,55,075,"Marinette County, Wisconsin",5168,2229,2939
50,WI,55,077,"Marquette County, Wisconsin",2069,994,1075
51,WI,55,078,"Menominee County, Wisconsin",1535,735,800
52,WI,55,079,"Milwaukee County, Wisconsin",201124,91053,110071
53,WI,55,081,"Monroe County, Wisconsin",6676,3011,3665
54,WI,55,083,"Oconto County, Wisconsin",3466,1682,1784
55,WI,55,085,"Oneida County, Wisconsin",3632,1646,1986
56,WI,55,087,"Outagamie County, Wisconsin",15723,7230,8493
57,WI,55,089,"Ozaukee County, Wisconsin",4467,1716,2751
58,WI,55,091,"Pepin County, Wisconsin",947,403,544
59,WI,55,093,"Pierce County, Wisconsin",4615,2047,2568
60,WI,55,095,"Polk County, Wisconsin",4407,1978,2429
61,WI,55,097,"Portage County, Wisconsin",10095,5009,5086
62,WI,55,099,"Price County, Wisconsin",1860,888,972
63,WI,55,101,"Racine County, Wisconsin",23768,9979,13789
64,WI,55,103,"Richland County, Wisconsin",2609,1271,1338
65,WI,55,105,"Rock County, Wisconsin",23498,10753,12745
66,WI,55,107,"Rusk County, Wisconsin",2252,1121,1131
67,WI,55,109,"St. Croix County, Wisconsin",5502,2468,3034
68,WI,55,111,"Sauk County, Wisconsin",7656,3355,4301
69,WI,55,113,"Sawyer County, Wisconsin",2673,1195,1478
70,WI,55,115,"Shawano County, Wisconsin",4451,1998,2453
71,WI,55,117,"Sheboygan County, Wisconsin",10348,4731,5617
72,WI,55,119,"Taylor County, Wisconsin",2527,1150,1377
73,WI,55,121,"Trempealeau County, Wisconsin",3078,1355,1723
74,WI,55,123,"Vernon County, Wisconsin",4757,2125,2632
75,WI,55,125,"Vilas County, Wisconsin",3047,1365,1682
76,WI,55,127,"Walworth County, Wisconsin",13499,5855,7644
77,WI,55,129,"Washburn County, Wisconsin",2022,911,1111
78,WI,55,131,"Washington County, Wisconsin",7375,2950,4425
79,WI,55,133,"Waukesha County, Wisconsin",20433,8852,11581
80,WI,55,135,"Waupaca County, Wisconsin",5232,2328,2904
81,WI,55,137,"Waushara County, Wisconsin",2385,1092,1293
82,WI,55,139,"Winnebago County, Wisconsin",19209,8291,10918
83,WI,55,141,"Wood County, Wisconsin",7996,3644,4352
12,WV,54,001,"Barbour County, West Virginia",3482,1682,1800
13,WV,54,003,"Berkeley County, West Virginia",15235,6801,8434
14,WV,54,005,"Boone County, West Virginia",5529,2643,2886
15,WV,54,007,"Braxton County, West Virginia",2941,1496,1445
16,WV,54,009,"Brooke County, West Virginia",2960,1290,1670
17,WV,54,011,"Cabell County, West Virginia",20110,8964,11146
18,WV,54,013,"Calhoun County, West Virginia",1314,569,745
19,WV,54,015,"Clay County, West Virginia",2530,1119,1411
20,WV,54,017,"Doddridge County, West Virginia",1190,457,733
21,WV,54,019,"Fayette County, West Virginia",8683,3956,4727
22,WV,54,021,"Gilmer County, West Virginia",1781,977,804
23,WV,54,023,"Grant County, West Virginia",1791,882,909
24,WV,54,025,"Greenbrier County, West Virginia",6530,2939,3591
25,WV,54,027,"Hampshire County, West Virginia",4721,2317,2404
26,WV,54,029,"Hancock County, West Virginia",4835,2034,2801
27,WV,54,031,"Hardy County, West Virginia",1863,773,1090
28,WV,54,033,"Harrison County, West Virginia",11072,4992,6080
29,WV,54,035,"Jackson County, West Virginia",4743,2268,2475
30,WV,54,037,"Jefferson County, West Virginia",6222,2521,3701
31,WV,54,039,"Kanawha County, West Virginia",29703,13258,16445
32,WV,54,041,"Lewis County, West Virginia",3357,1583,1774
33,WV,54,043,"Lincoln County, West Virginia",5870,2758,3112
34,WV,54,045,"Logan County, West Virginia",6902,2915,3987
35,WV,54,047,"McDowell County, West Virginia",6943,3196,3747
36,WV,54,049,"Marion County, West Virginia",8980,4005,4975
37,WV,54,051,"Marshall County, West Virginia",4128,1676,2452
38,WV,54,053,"Mason County, West Virginia",5075,2409,2666
39,WV,54,055,"Mercer County, West Virginia",13236,5322,7914
40,WV,54,057,"Mineral County, West Virginia",4562,2071,2491
41,WV,54,059,"Mingo County, West Virginia",6654,2873,3781
42,WV,54,061,"Monongalia County, West Virginia",20923,10509,10414
43,WV,54,063,"Monroe County, West Virginia",2252,894,1358
44,WV,54,065,"Morgan County, West Virginia",2218,879,1339
45,WV,54,067,"Nicholas County, West Virginia",4636,2006,2630
46,WV,54,069,"Ohio County, West Virginia",6658,2958,3700
47,WV,54,071,"Pendleton County, West Virginia",1500,776,724
48,WV,54,073,"Pleasants County, West Virginia",1260,616,644
49,WV,54,075,"Pocahontas County, West Virginia",1382,568,814
50,WV,54,077,"Preston County, West Virginia",4574,2002,2572
51,WV,54,079,"Putnam County, West Virginia",5494,2026,3468
52,WV,54,081,"Raleigh County, West Virginia",13322,5897,7425
53,WV,54,083,"Randolph County, West Virginia",4610,1968,2642
54,WV,54,085,"Ritchie County, West Virginia",2071,995,1076
55,WV,54,087,"Roane County, West Virginia",3165,1382,1783
56,WV,54,089,"Summers County, West Virginia",2184,1100,1084
57,WV,54,091,"Taylor County, West Virginia",2731,1296,1435
58,WV,54,093,"Tucker County, West Virginia",1013,450,563
59,WV,54,095,"Tyler County, West Virginia",1765,675,1090
60,WV,54,097,"Upshur County, West Virginia",4189,1928,2261
61,WV,54,099,"Wayne County, West Virginia",8468,3971,4497
62,WV,54,101,"Webster County, West Virginia",2307,1033,1274
63,WV,54,103,"Wetzel County, West Virginia",3169,1354,1815
64,WV,54,105,"Wirt County, West Virginia",792,291,501
65,WV,54,107,"Wood County, West Virginia",14825,6309,8516
66,WV,54,109,"Wyoming County, West Virginia",4934,2320,2614
12,WY,56,001,"Albany County, Wyoming",9510,4748,4762
13,WY,56,003,"Big Horn County, Wyoming",1408,632,776
14,WY,56,005,"Campbell County, Wyoming",3412,1380,2032
15,WY,56,007,"Carbon County, Wyoming",2280,948,1332
16,WY,56,009,"Converse County, Wyoming",1308,486,822
17,WY,56,011,"Crook County, Wyoming",362,206,156
18,WY,56,013,"Fremont County, Wyoming",5637,2586,3051
19,WY,56,015,"Goshen County, Wyoming",2261,1048,1213
20,WY,56,017,"Hot Springs County, Wyoming",500,140,360
21,WY,56,019,"Johnson County, Wyoming",534,294,240
22,WY,56,021,"Laramie County, Wyoming",9369,3777,5592
23,WY,56,023,"Lincoln County, Wyoming",1435,662,773
24,WY,56,025,"Natrona County, Wyoming",8407,3605,4802
25,WY,56,027,"Niobrara County, Wyoming",328,154,174
26,WY,56,029,"Park County, Wyoming",2024,492,1532
27,WY,56,031,"Platte County, Wyoming",1391,562,829
28,WY,56,033,"Sheridan County, Wyoming",2381,1210,1171
29,WY,56,035,"Sublette County, Wyoming",812,453,359
30,WY,56,037,"Sweetwater County, Wyoming",5058,2177,2881
31,WY,56,039,"Teton County, Wyoming",1638,1026,612
32,WY,56,041,"Uinta County, Wyoming",2845,1453,1392
33,WY,56,043,"Washakie County, Wyoming",1137,489,648
34,WY,56,045,"Weston County, Wyoming",958,354,604
